A	a
A	a
a	a
a	a
aanwijzing	a n . w ɛ i . z ɪ ŋ
AB	ˈa b e
abad	a . b a t̚
abah	ˈa . b a h
abahan	ˈa b a h a n
abalalu	a b a ˈl a l u
abam	ˈa b a m
abdas	ˈa p d a s
abdi	a b . d i
abdis	ˈa b d ɪ s
abi	a b i
abilah	ˈa b i l a h
abir	ˈa b ɪ r
abiseka	a b i . s e . k a
abiti	ˈa b i t i
ABK	a b e k a
aboi	ˈa . b o i̯
abonemen	a b o n ə ˈm ɛ n
aborigin	a . b o . r i . ɡ ɪ n
aborsi	ˈa b ɔ r s i
abortus	ˈa b ɔ r t̪ ʊ s
abras	a b . r a s
abrasif	a . ˈb r a . s ɪ f
absolusi	a b s o l u s i
absolutis	a p . s o . ˈl u . t ɪ s
abstain	a p̚ s t a i n
abu	a b u
abu	a b u
abur	ˈa b ʊ r
acapkali	a t͡ʃ a p ˈk a l i
acar	ˈa t͡ʃ a r
Aceh	a t͡ʃ e h
aci	a t͡ʃ i
aci	a t͡ʃ i
aci	a t͡ʃ i
aci	a t͡ʃ i
acik	a . t͡ʃ ɪ ʔ
ada	ˈʔ ä . d ä
adalah	ˈa d a l a h
adaptif	ˈa d a p . t ɪ f
adas	ˈa d a s
adat	a . d a t
Adelina	ˈa d e l i n a
adempauze	a d ə m . p a u̯ . z ə
adenilat	a . d e . ˈn i . l a t
adenoma	a . d e . n o . m a
adenopati	a . d ə . n o . ˈp a . t i
adenosina	a . d e . n o . ˈs i . n a
adenovirus	a . d e . n o . ˈv i . r ʊ s
adermatoglifia	a d ə r m a t o ˈɡ l i f i a̯
adhesif	a b o n ə m ɛ n
adiafora	a d i a ˈf o r a
adiaksa	a d i ˈa k s a
adicita	a d i ˈt͡ʃ i t a
adijana	a . d i . ˈd͡ʒ a . n a
adik	ˈa . d ɪ k
adikara	a d i . k a . r a
adikarya	a d i k a r j a
adiksimba	a d ɪ k ˈs ɪ m b a
adil	a . d i l
adimanusia	a . d i . m a . n u . ˈs i . a
adipenghantar	a d i p ə ŋ ˈh a n t a r
adiperagawan	a d i p ə r a ˈɡ a w a n
adiposa	a d i ˈp o s a
adiraja	a d i . ˈr a . d͡ʒ a
adisi	a . ˈd i . s i
aditif	a . ˈd i . t ɪ f
adiwastra	a d i ˈw a s t r a
adiwicara	a d i w i ˈt͡ʃ a r a
adiyuswa	a d i ˈj ʊ s w a
administrator	a t̚ m i n ɪ s t r a t ɔ r
administratur	a t̚ m i n ɪ s t r a t ʊ r
adodui	ˈa d o d u i̯
adoptif	ˈa d ɔ p . t ɪ f
adorasi	a . d o . ˈr a . s i
adpis	ˈa t̚ p ɪ s
adsorpsi	a t ˈs ɔ r p s i
adu	ˈa d u
adutan	ˈa d ʊ t a n
advis	a t̚ . v i s
advis	a t̚ . f i s
advisor	a t . ˈv i . s ɔ r
advisori	a t . v i . ˈs o . r i
aerasi	a e ˈr a s i
aeropolis	a e r o ˈp o l ɪ s
afa	ˈa f a
afdeling	a f . d e . l i ŋ
afiliator	a f i l i ˈa t ɔ r
afirmasi	a f ɪ r ˈm a s i
aforestasi	a f o r ɛ s ˈt a s i
afsun	ˈa f s ʊ n
aftab	ˈa f t a p̚
afwan	ˈa f . w a n
agape	a ɡ a p e
agar	ˈa ɡ a r
Agatha	ˈa ɡ a t a
ageisme	a ɡ e ˈɪ s m ə
ageman	a ɡ ə ˈm a n
agen	ˈa . ɡ ɛ n
agih	ˈa ɡ ɪ h
agihan	a ɡ i h a n
agit	ˈa ɡ ɪ t̚
agmaman	a ɡ ˈm a m a n
agraris	ˈa ɡ r a r ɪ s
agresi	a ɡ . r ɛ . s i
agrowisata	a ɡ r o w i ˈs a t a
agul	ˈa ɡ ʊ l
agunan	a . ˈɡ ʊ n . a n
agung	ˈa ɡ ʊ ŋ
Agustus	a . ˈɡ ʊ s . t ʊ s
ah	ˈa h
ahad	ˈa h a t̚
Ahad	ˈa h a t̚
ahi	ˈa h i
ahin	ˈa h ɪ n
ahli	ˈa h l i
ahuh	ˈa h ʊ h
ahutu	a ˈh u t u
aib	aʲ i b
aikido	aʲ i . k i . d o
aikido	a i̯ . k i . d o
air	ˈʔ ä . j i r
ais	ˈa ʔ ɪ s
ajakan	a . ˈd͡ʒ a k . a n
ajal	ˈa d͡ʒ a l
ajar	a . d͡ʒ a r
ajara	ˈa d͡ʒ a r a
ajaran	a d͡ʒ a r a n
aji	ˈa d͡ʒ i
ajib	ˈa d͡ʒ ɪ p̚
ajir	ˈa . d͡ʒ ɪ r
ajo	ˈa d͡ʒ o
akademi	a k a . d e . m i
akal	ˈa k a l
akan	a . k a n
akang	a k a ŋ
akar	a . k a r
akas	ˈa . k a s
akatopi	a k a ˈt o p i
akelit	ˈa k ɛ l ɪ t̚
akeo	a k e o
akeul	ˈa . k ɘ l
akhirat	a . ˈx i . r a t
akhlak	ˈa x l a k
akidah	ˈa k i d a h
akil	a . k ɪ l
ako	a k e o
akrasia	a . k r a . ˈs i . a
akresi	a . ˈk r e . s i
akrilamida	a k r i l a ˈm i d a
akrual	a k . ˈr u . a l
aksa	ˈa k̚ s a
aksara	a k . s a . r a
akselerasi	a k s e l ə ˈr a s i
akselerator	a k . s e . l ə . ˈr a . t ɔ r
akseptasi	a k . s ɛ p . ˈt a . s i
aksiomatik	a k . s i . o . ˈm a . t ɪ k
aksis	ˈa k . s ɪ s
akta	a k̚ t a
aktan	ˈa k̚ t a n
akte	a k̚ t ə
aktif	a k̚ t ɪ f
aktif	a k̚ t ɪ p
aktifitas	a k̚ t i f i t a s
aktivasi	a k̚ t i v a s i
aktivasi	a k̚ t i f a s i
aktivasi	a k̚ t i p a s i
aktivator	a k t i ˈv a t ɔ r
aktivis	a k̚ t i v ɪ s
aktivis	a k̚ t i f ɪ s
aktivis	a k̚ t i p ɪ s
aktivisme	a k̚ t i v ɪ s m ə
aktivisme	a k̚ t i f ɪ s m ə
aktivisme	a k̚ t i p ɪ s m ə
aktivitas	a k̚ t i v i t a s
aktivitas	a k̚ t i f i t a s
aktivitas	a k̚ t i p i t a s
aktris	ˈa k t r ɪ s
aktuaria	a k . t u . a . ˈr i . a
aktuator	a k t u ˈa t ɔ r
akuene	a k u ˈe n e
akut	a . k u t
alamete	a l a ˈm ɛ t e
alami	ˈa l a m i
alanggaya	a l a ŋ ˈɡ a j a
alar	ˈa l a r
alarm	ˈa l a r m
alas	a . l a s
alasan	ˈa l a s a n
alat	a l a t
alawatae	a l a ˈm ɛ t e
albatros	a l . ˈb a . t r ɔ s
aldehida	a l d e ˈh i d a
alei	ˈa l e i
alel	ˈa . l ɛ l
aler	ˈa l ɛ r
alewar	ˈa l e w a r
alfa	ˈa l . f a
alfa	ˈa l . p a
alferes	a l ˈf e r e s
alfuil	a l ˈf u ɪ l
algojo	a l ˈɡ o d͡ʒ o
algoritmik	a l ɡ o ˈr ɪ t̚ m ɪ k̚
algoritmis	a l ɡ o ˈr ɪ t̚ m ɪ s
ali	ˈa l i
aliah	a l i a h
aliansi	a l i ˈa n s i
aliase	a l i ˈa s ə
alir	ˈa . l ɪ r
aliran	a . ˈl ɪ r . a n
alis	ˈʔ ä . l i s
alkali	a l ˈk a . l i
alkana	a l . k a . n a
Allah	ɑ l l ɑ h
Allah	ɑ w l o h
Allah	a l l a h
almarhum	a l ˈm a r h ʊ m
almarhumah	a l m a r ˈh u m a h
alngilin	a l ˈŋ i l ɪ n
alodna	a . ˈl ɔ t . n a
aloi	ˈa l o i̯
alokai	ˈa l o k a i̯
alopesia	a l o ˈp e s i a̯
alot	ˈa l ɔ t̚
aloun	a . ˈl o . ʊ n
alpa	a l . p a
alpiris	a l . ˈp i . r ɪ s
alpukat	a l p u k a t
altar	ˈa l t a r
altitudo	a l t i ˈt u d o
aluakas	a l u ˈa k a s
alumpa	ˈa l ʊ m p a
alur	ˈa l ʊ r
alutta	ˈa l ʊ t t a
alwah	ˈa l w a h
am	ˈa m
amah	a m a h
amah	a m a h
amahatua	a m a ˈh a t u a̯
amali	a . ˈm a . l i
amalo	ˈa m a l o
aman	a . m a n
amanah	ˈa m a n a h
amanat	ˈa m a n a t̚
amane	ˈa m a n ɛ
amango	a . ˈm a . ŋ o
amanra	ˈa m a n r o
amar	ˈa m a r
amati	a . ˈm a . t i
amato	ˈa m a t o
amau	a b u
amau	a ˈm a u
ambaks	ˈa m b a k s
ambasade	a m b a ˈs a d ə
ambataron	a m b a ˈt a r ɔ n
ambekara	a m b e ˈk a r a
ambekdarma	a m b ə k̚ ˈd a r m a
ambekpati	a m b ə k̚ ˈp a t i
amben	ˈa m b ə n
ambideksteritas	a m b i d ɛ k s t ɛ ˈr i t a s
ambidekstrus	a m b i ˈd ɛ k s t r ʊ s
ambiguitas	a m b i ɡ u ˈi t a s
ambil	ˈa m b ɪ l
ambin	ˈa m b ɪ n
ambir	ˈa m b ɪ r
ambis	ˈa m . b ɪ s
ambisius	a m . b i . ˈs i . ʊ s
amblong	ˈa m b l ɔ ŋ
ambo	ˈa m . b o
ambong	ˈa m b ɔ ŋ
ambu	ˈa m b u
ambuh	ˈa m b ʊ h
ambulralra	a m b ʊ l ˈr a l r a
amburat	a m ˈb u r a t̚
ambyang	ˈa m bʲ a ŋ
ambyok	ˈa m b j ɔ k̚
ambyur	ˈa m bʲ ʊ r
amegop	a . ˈm ə . ɡ ɔ p
amenitas	a . m e . ˈn i . t a s
amer	ˈa m ɛ r
Amerika	a m e ˈr i k a
amerta	a m ə r . t a
amesureng	a m e ˈs u r ə ŋ
ameto	a . ˈm e . t o
amfibi	a m ˈf i b i
amih	ˈa . m ɪ h
amilum	ˈa m i l ʊ m
amin	ˈa . m ɪ n
amiug	ˈa m i ʊ k̚
amleng	ˈa m . l ə ŋ
amo	ˈa m o
amoa	ˈa m o a̯
amoh	ˈa m ɔ h
among	ˈa m ɔ ŋ
amonga	ˈa m o ŋ a
ampa	ˈa m p a
ampal	ˈa m p a l
ampig	ˈa m p ɪ k
ampikale	a m p i ˈk a l e
ampilalas	a m p i ˈl a l a s
amplek	ˈa m p l ɛ k̚
amplokan	a m ˈp l o k a n
amplop	ˈa m p l ɔ p
ampor	ˈa m p ɔ r
amporang	a m ˈp o r a ŋ
amporo	a m ˈp o r o
ampot	ˈa m p ɔ t̚
ampu	ˈa m . p u
ampul	a m . p ʊ l
amput	ˈa m p ʊ t̚
amputan	a m ˈp ʊ t a n
amra	a m r a
amudi	ˈa m u d i
amuk	ˈa m ʊ k̚
ana	a n a
anaheha	a n a ˈh e h a
anak	a . n a k
anak	a . n a ʔ
anakia	ˈa n a k i a̯
anakompo	a n a ˈk ɔ m p o
anakonda	a . n a . ˈk ɔ n . d a
analisis	a n a ˈl i s ɪ s
analitis	a n a ˈl i t ɪ s
anamolepo	a n a m o ˈl e p o
anangkolaki	a n a ŋ k o ˈl a k i
ananim	ˈa n a n ɪ m
anapaso	a n a ˈp a s o
anaplasmosis	a . n a . p l a s . ˈm o . s ɪ s
anaria	a . n a . ˈr i . a
anastilosis	a . n a . s t i . ˈl o . s ɪ s
Anatolia	a . n a . t o . ˈl i . a
anau	ˈa n a u̯
anaweli	a . n a . ˈw e . l i
anaye	ˈa n a j ɛ
ancai	ˈa n t͡ʃ a i̯
ancak	ˈa n t͡ʃ a k̚
ancala	a n t͡ʃ a l a
ancaman	a n . t͡ʃ a . m a n
ancok	ˈa n t͡ʃ ɔ k̚
ancruk	ˈa n t͡ʃ r ʊ k̚
ancuan	a n ˈt͡ʃ u a n
ancumcum	a n ˈt͡ʃ ʊ m t͡ʃ ʊ m
ancur	ˈa n . t͡ʃ ʊ r
ancut	ˈa n . t͡ʃ ʊ t
Anda	ˈa n d a
andaka	n a n d a k a
andala	a n ˈd a l a
andalas	a n . ˈd a . l a s
andam	ˈa n d a m
andap	ˈa n . d a p
andege	a n ˈd e ɡ e
andem	ˈa n d ə m
andeman	a n d ə ˈm a n
andir	ˈa n d ɪ r
Andorra	a n ˈd ɔ r r a
andostorang	a n d ɔ s ˈt o r a ŋ
andung	ˈa n d ʊ ŋ
andurabian	a n d u r a ˈb i a n
anehe	ˈa n e h e
aneka	a n ɛ . k a
aneksi	a . ˈn ɛ k . s i
anfakah	a n ˈf a k a h
anfal	a n . f a l
angai	ˈa ŋ a i̯
angciu	a ŋ t͡ʃ i u
anggal	ˈa ŋ . ɡ a l
anggana	a ŋ ˈɡ a n a
anggap	ˈa ŋ ɡ a p̚
anggara	a ŋ ˈɡ a r a
anggas	ˈa ŋ ɡ a s
anggi	ˈa ŋ ɡ i
anggong	ˈa ŋ ɡ ɔ ŋ
anggrang	ˈa ŋ . ɡ r a ŋ
anggrek	ˈa ŋ ɡ r ɛ ʔ
anggu	ˈa ŋ ɡ u
anggus	ˈa ŋ ɡ ʊ s
anghengar	a ŋ ˈh e ŋ a r
anghun	a ŋ . h u n
angik	ˈa ŋ ɪ k
angin	ˈa ŋ i n
angka	a ŋ k a
angkak	a ŋ k a k
angkar	ˈa ŋ k a r
angkasa	a ŋ . k a . s a
angkasawan	a ŋ k a s a w a n
angkatan	a ŋ ˈk a t a n
angki	ˈa ŋ k i
angko	ˈa ŋ k o
angkop	ˈa ŋ k ɔ p̚
angkrok	ˈa ŋ k r ɔ k̚
angkruk	ˈa ŋ k r ʊ k̚
angkur	ˈa ŋ . k ʊ r
angkusa	a ŋ k u s a
angkutan	a ŋ ˈk ʊ t a n
anglek	ˈa ŋ l ə k̚
anglo	a ŋ . l o
anglung	a ŋ . l u ŋ
angpao	a ŋ . p a o
angpau	a ŋ . p a u̯
angrem	a ŋ r ə m
angsana	a ŋ ˈs a n a
angsang	ˈa ŋ s a ŋ
angsongar	a ŋ ˈs o ŋ a r
angsung	ˈa ŋ s ʊ ŋ
angwain	a ŋ ˈw a ɪ n
aniaya	a n i . a . j a
anido	ˈa n i d o
animasi	a n i ˈm a s i
animator	a . n i . ˈm a . t ɔ r
aningo	a . ˈn i . ŋ o
aniwui	ˈa n i w u i̯
anjal	ˈa n d͡ʒ a l
anjang	ˈa n d͡ʒ a ŋ
anjar	ˈa n d͡ʒ a r
anjeng	ˈa n d͡ʒ ɛ ŋ
anjer	ˈa n d͡ʒ ə r
anjiman	a n ˈd͡ʒ i m a n
anjing	ˈa n d͡ʒ i ŋ
anjok	ˈa n d͡ʒ ɔ k
anjul	ˈa n d͡ʒ ʊ l
ankanan	a n ˈk a n a n
Ankara	a n ˈk a r a
anoda	a . n o . d a
anoda	a n o . d a
anode	a . n o . d ə
anode	a n o . d ə
ansai	ˈa n . s a i̯
ansambel	a n ˈs a m b ə l
ansos	a n . s o s
anta	ˈa n t a
antaladan	a n . t a . ˈl a . d a n
antanik	a n ˈt a n ɪ k̚
antarbahasa	a n t a r b a ˈh a s a
antarbangsa	a n t a r b a ŋ s a
antardesa	a n t a r ˈd ɛ s a
antariksawan	a n t a r ɪ k s a w a n
antarpemain	a n t a r p ə ˈm a ɪ n
Antartika	a n t a r ˈt i k a
antero	a n ˈt e r o
antesis	a n ˈt e s ɪ s
antidot	a n . ˈt i . d ɔ t
antidotum	a n . t i ˈd o . t ʊ m
antigen	a n . ˈt i . ɡ ɛ n
antik	a n . t i k
antil	ˈa n t ɪ l
antimikroba	a n t i m i ˈk r o b a
anting	a n t i ŋ
antofilia	a n . t o . f i . ˈl i . a
antok	ˈa n t ɔ k̚
antolong	a n ˈt o l ɔ ŋ
antor	ˈa n t ɔ r
antrap	ˈa n t r a p̚
antuk	ˈa n t u k
antulawo	a n . t u . ˈl a . w o
antum	ˈa n t ʊ m
antung	ˈa n . t ʊ ŋ
antunga	a n . ˈt u . ŋ a
anua	a . ˈn u . a
anudun	a . ˈn u . d ʊ n
anuhuai	a . n u . ˈh u . a i̯
anuitas	a . n u . ˈi . t a s
anumerta	a n u . m ə r . t a
anungo	a . ˈn u . ŋ o
anvian	a n . ˈv i . a n
anyam	ˈa ɲ a m
anyir	a ɲ ɪ r
aora	a . ˈo . r a
aota	a . ˈo . t a
apa	a p a
apak	a p a ʔ
apakah	a p a . k a h
apanase	a p a ˈn a s ə
apang	ˈa p a ŋ
aparat	a p a r a t
apek	a . p ɛ k
apek	a p ə k
apen	ˈa p ə n
apiun	ˈa p i ʊ n
aplaus	a p . l a . u s
aplikan	a p̚ ˈl i k a n
aplikatif	a p l i ˈk a t ɪ f
apo	ˈa . p o
apokdim	a . ˈp ɔ ʔ . d ɪ m
apoking	a . ˈp o . k ɪ ŋ
apologi	a p o ˈl o ɡ i
apologia	a p o ˈl o ɡ i a̯
aporia	a . p o . ˈr i . a
apotek	a p o . t e k
APPU	a . p e . ˈp e . u
April	ˈa p̚ . r ɪ l
apsara	a p . s a . r a
apsari	a p̚ ˈs a r i
ara	ˈa r a
Arab	ˈa r a p̚
arababu	a r a ˈb a b u
arak	a . r a k
aral	ˈa r a l
arambasi	a r a m ˈb a s i
arapota	a . r a . ˈp o . t a
arat	ˈa r a t̚
arbei	a r . b e i̯
arbor	ˈa r b ɔ r
ardi	ˈa r . d i
argentum	a r . ˈɡ ɛ n . t ʊ m
argiria	a r ˈɡ i r i a̯
argo	ˈa r . ɡ o
argometer	a r . ɡ o . ˈm e . t ə r
arhir	ˈa r . h ɪ r
ari	ˈa . r i
aria	ˈa r i a̯
arid	ˈa r ɪ t̚
arif	ˈa r ɪ f
arigol	ˈa . r i . ɡ ɔ l
arit	a . r i t
aritmatika	a . r i t . m a . t i . k a
aritmetika	a . r i t . m ɛ . t i . k a
arjer	ˈa r . d͡ʒ ɛ r
arkunel	a r . ˈk u . n ɛ l
arlindo	a r . ˈl ɪ n . d o
arloji	a r l o d͡ʒ i
arowon	a . ˈr o . w ɔ n
arta	a r . t a
arti	a r . t i
artikula	a r . t i . ˈk u . l a
artrok	ˈa r t . r ɔ k
artropoda	a r t r o ˈp o d a
arugula	a b o n ə m ɛ n
aruna	ˈa r u n a
arunika	a . r u . ˈn i . k a
arupera	a . r u . ˈp e . r a
aruris	a . ˈr u . r ɪ s
arus	ˈa . r ʊ s
arustama	a . r ʊ s . ˈt a . m a
arwah	ˈa r . w a h
arwer	ˈa r w ɛ r
arya	a r . j a
AS	ˈa . ɛ s
asah	ˈa s a h
asai	ˈa . s a i̯
asakue	ˈa s a k u e̯
asal	ˈa . s a l
asalamualaikum	a s . s a . ˌl a m . m u . a . l a j ˈk u m
asam	ˈa s a m
asat	ˈa s a t̚
asbabulwurud	a s . b a . b ʊ l . ˈw u . r ʊ t
asbak	a s . b a k
asbun	a s . b u n
asbuton	a s . ˈb u . t ɔ n
ASEAN	a ˈs e a n
asesmen	a s ɛ s m ə n
asid	ˈa s ɪ t
asidulan	a s i . ˈd u . l a n
asin	ˈa s ɪ n
asinan	ˈa s ɪ n a n
asinkron	a . ˈs ɪ n . k r ɔ n
asinkronus	a . s ɪ n . ˈk r ɔ n . ʊ s
asiri	ˈa s i r i
asistol	a . ˈs ɪ s . t ɔ l
asjetan	a s . ˈd͡ʒ e . t a n
askasdam	a s . ˈk a s . d a m
askese	a s k e s ə
aslesar	a s . ˈl e . s a r
aslosin	a s . ˈl o . s ɪ n
asma	ˈa s m a
asmara	a s . m a . r a
asmaraguna	a s . m a . r a . ˈɡ u . n a
asonisoni	a . s o . n i . ˈs o . n i
aspal	a s . p a l
aspergilosis	a s . p ə r . ɡ i . ˈl o . s ɪ s
asrama	a s . r a . m a
asrok	ˈa s . r ɔ k
astana	a s . t a . n a
asteris	a s t ə ˈr ɪ s
astronaut	a s t r o n a u̯ t̚
astronaut	a s t r o n ɔ t̚
asuhan	a . ˈs ʊ h . a n
asumsi	a ˈs ʊ m s i
aswa	a s . w a
asyik	a . ʃ ɪ k
asyik	a . s ɪ k
asyik	a s . j ɪ k
atan	ˈa t a n
ataninai	a . t a . n i . ˈn a . i
atas	ˈa t a s
atau	a t a u̯
ate	ˈa . t e
ateisme	a t e ˈɪ s m ə
atela	a t ə . ˈl a
atestasi	a t ɛ s . ˈt a . s i
atma	a t . m a
atmosferis	a t m ɔ s ˈf ɛ r ɪ s
atom	ˈa t ɔ m
atur	ˈa t ʊ r
auban	a u . b a n
audial	a u̯ . ˈd i . a l
audiometer	a u̯ . d i . o . ˈm e . t ə r
audiometri	a u̯ . d i . o . ˈm e . t r i
audit	ˈa u̯ . d ɪ t
audite	a u̯ . ˈd i . t e
auditori	a u̯ . d i . ˈt o . r i
Austria	a ʊ s ˈt r i a
autokrasi	a u t o k r a s i
autokrat	a u t o k r a t̚
automasi	a u̯ t o ˈm a s i
autotrof	a u̯ . t o . t r o f
avatar	a v a t a r
averoisme	a . v e . r o . ˈɪ s . m ə
aviditas	a . v i . ˈd i . t a s
avtur	ˈa f t ʊ r
avtur	ˈa p̚ t ʊ r
awaagama	a . w a . a . ˈɡ a . m a
awak	a w a k
awak	a w a ʔ
awam	ˈa w a m
awar	ˈa w a r
awas	ˈa w a s
awat	a . w a t
awelat	a . ˈw e . l a t̚
awet	ˈa . w ɛ t
awetan	a . ˈw ɛ t . a n
awo	ˈa w o
awota	ˈa w o . t a
awuhu	ˈa w u . h u
awur	ˈa w ʊ r
awuta	ˈa w u . t a
ayah	a . j a h
ayam	a . j a m
ayanginahe	a j a . ŋ i . ˈn a . h ə
ayeuh	a ˈj ɤ h
ayeuh	a ˈj ə h
ayo	a ˈj o
ayomas	a . ˈj o . m a s
ayun	ˈa j ʊ n
azan	ˈa z a n
b	b e
b	b
B	b e
B	b
baawu	b a . ˈa . w u
bab	b a b
baba	ˈb a . b a
babad	ˈb a b a t̚
babango	b a . ˈb a . ŋ o
babatan	b a . ˈb a t . a n
babaun	b a . ˈb a . ʊ n
Babel	b a ˈb ə l
babelan	b a . ˈb e . l a n
babelih	b a . b ə . ˈl ɪ h
babi	ˈb a b i
babka	ˈb a p . k a
babo	ˈb a . b o
babu	ˈb a b u
baca	b a . t͡ʃ a
bacaan	b a ˈt͡ʃ a a n
bacang	b a . t͡ʃ a ŋ
bacok	ˈb a . t͡ʃ ɔ ʔ
bacot	b a ˈc o t
bad	ˈb a t̚
badak	ˈb a . d a ʔ
badam	ˈb a d a m
badar	ˈb a . d a r
badare	b a . ˈd a . r ə
badek	ˈb a . d ə k
badenga	b a . ˈd e . ŋ a
badi	ˈb a d i
badola	b a . ˈd o . l a
badul	ˈb a . d ʊ l
baftah	ˈb a f t a h
bagai	b a ɡ a i̯
bagan	ˈb a . ɡ a n
bagel	ˈb a ɡ ə l
bagi	b a . ɡ i
bagian	b a ˈɡ iʲ a n
baginda	b a ɡ i n d a
bagong	b a . ɡ ɔ ŋ
bahadur	b a ˈh a d ʊ r
bahasa	b ä . ˈh ä . s ä
bahaya	b a ˈh a j a
bahtera	b a h . t ə . r a
bahu	ˈb ä . h u
bahwa	b a h . w a
baiduri	b a i̯ . d u . r i
baik	ˈb a i ʔ
baja	b a . d͡ʒ a
bajaj	ˈb a . d ʒ a i̯
bajing	ˈb a . d͡ʒ ɪ ŋ
bajingan	b a . d͡ʒ i ŋ . a n
bak	b a k
bak	b ɑ k
bak	b a k
bak	b a k
bakal	ˈb a . k a l
bakat	ˈb a k a t̚
bakcang	b a ʔ . t͡ʃ a ŋ
bakeri	b a k ə ˈr i
bakero	b a k e r o
bakh	ˈb a x
baki	ˈb a k i
bakiak	b a . k i . a k
bakmi	b a k . m i
bakpao	b a ʔ p a o
bakpau	b a k . p a ʊ̯
bakpia	b a ʔ p i a̯
baksis	ˈb a k s ɪ s
bakso	b a ʔ s o
baktau	b a k . t a ʊ̯
bakti	b a k . t i
bakwan	b a ʔ w a n
bala	b a . l a
bala	b a . l a
bala	b a . l a
balabad	b a ˈl a b a t̚
balai	ˈb a l a i̯
balai	b a ˈl a i
balairung	b a . ˈl a i̯ . r ʊ ŋ
balak	ˈb a l a ʔ
Bali	b a l i
balig	ˈb a l ɪ k̚
balik	ˈb a l ɪ k̚
balikan	b a l i k a n
balim	ˈb a l ɪ m
baling	ˈb a l ɪ ŋ
balo	ˈb a l o
balobo	b a ˈl o b o
baloh	ˈb a l ɔ h
balok	b a . l o k
balot	b a l ɔ t̚
balugut	b a ˈl u ɡ ʊ t̚
balumba	b a ˈl ʊ m b a
balur	ˈb a l ʊ r
bam	ˈb a m
bancak	b a n t͡ʃ a ʔ
bancakan	b a n ˈt͡ʃ a k a n
banci	b a n . t͡ʃ i
bandara	b a n ˈd a r a
banding	ˈb a n d ɪ ŋ
bandung	ˈb a n . d ʊ ŋ
bang	b a ŋ
bangau	ˈb a ŋ a u̯
bangka	ˈb a ŋ . k a
bangku	ˈb ä ŋ . k u
bangsa	b a ŋ . s a
bangsat	b a ŋ . s a t
bangsi	b a ŋ . s i
bangun	ˈb a ŋ ʊ n
banji	b a n . d͡ʒ i
banjir	ˈb a n . d͡ʒ ɪ r
bank	b a ŋ
bantahan	b a n ˈt a h a n
bantal	ˈb a n t a l
banua	ˈb a n u a̯
banyak	b a ɲ a k
banzai	b a n . z a i̯
bapa	b a p a
Bapa	b a p a
bapak	b a p a ʔ
bapao	b a . p a o
barah	ˈb a . r a h
barid	ˈb a r ɪ t̚
barik	ˈb a r ɪ k̚
barikade	b a r i ˈk a d ə
bariton	b a ˈr i t ɔ n
barongsai	b a . r o ŋ . s a i̯
baronsai	b a . r o n . s a i̯
Baruna	b a . r u . n a
basahan	b a ˈs a h a n
basantara	b a . s a n . ˈt a . r a
baskara	b a s ˈk a r a
basket	b a s . ˈk ɛ t̚
basmati	b a s ˈm a t i
basmi	b a s . m i
Batam	ˈb a t a m
batang	b a t a ŋ
batangan	b a . t a ŋ . a n
batara	b a . t a . r a
batau	b a . t a ʊ̯
Batavia	b a . t a . v i a̯
batik	b a t ɪ k
batuan	b a ˈt u a n
batur	ˈb a t ʊ r
bausastra	b a . u . s a s . t r a
bawah	ˈb a w a h
bawang	ˈb a w a ŋ
bawi	b a . w i
baya	b a . j a
bayam	ˈb a . j a m
bayan	ˈb a j a n
bayang	ˈb a . j a ŋ
bayangan	b a ˈj a ŋ a n
bayangkara	b a . j a ŋ . k a . r a
bayu	b a j u
bazar	b a . z a r
BBLR	b e b e ˈɛ l ɛ r
bea	ˈb e a̯
beasiswa	b e . a ˈs ɪ s . w a
beban	b ə ˈb a n
bebas	b ɛ . b a s
beber	ˈb ɛ b ɛ r
bebetok	b ə b ə ˈt ɔ k̚
bedebah	b ə d ə ˈb a h
begawan	b ə . ɡ a . w a n
beha	b e . h a
bejo	b ə . d͡ʒ ɔ
bekintangon	b ɛ k ɪ n ˈt a ŋ ɔ n
bel	b ɛ l
bel	b ə l
bela	b ɛ . l a
belah	b ə . ˈl a h
belahan	b ə ˈl a h a n
belajar	b ə . l a . d͡ʒ a r
belalai	b ə l a l a i̯
Belanda	b ə . l a n . d a
belanja	b ə ˈl a n . d͡ʒ a
belanjaan	b ə ˈl a n . d͡ʒ a ʔ a n
belantara	b ə . l a n . t a . r a
Belarus	b e ˈl a r ʊ s
Belarusia	b e l a ˈr u s i a̯
belasting	b ə . l a s . t i ŋ
beledu	b ə l ə d u
beleran	b ɛ l ɛ ˈr aː n
beli	b ə ˈl i
belia	b ə . l i a̯
belom	b ə . l o m
belom	b ə . l ʌ m
belum	b ə ˈl ʊ m
benar	ˈb e . n a r
bencong	b ɛ n . t͡ʃ o ŋ
benda	b ə n . d a
bendahara	b ə n . d a . h a . r a
bendahari	b ə n . d a . h a . r i
bendel	b ə n ˈd ə l
bendera	b ə n ˈd ɛ r a
bendu	b ə n . ˈd u
benduan	b ə n . ˈd u . a n
bengal	b ə ˈŋ a l
bengawan	b ə . ŋ a . w a n
bengkel	ˈb ɛ ŋ k ɛ l
Bengkulu	b ə ŋ ˈk u l u
benih	b ə n ɪ h
benik	b ə ˈn ɪ k̚
bentar	b ə n ˈt a r
benzol	b e n . z o l
berada	b ə r a d a
beradab	b ə r ˈa d a p̚
berak	b ɛ . r a k
berak	b ɛ . r a ʔ
berakhiran	b ə r a ˈx ɪ r a n
berambang	b ə . ˈr a m . b a ŋ
berangkat	b ə . r a ŋ . k a t
berantas	b ə ˈr a n t a s
berapa	b ə . r a . p a
berat	b ə ˈr a t
berbahasa	b ə r b a ˈh a s a
berbahaya	b ə r . b a . h a . j a
berbaterai	b ə r b a t ə ˈr a i̯
berbeda	b ə r ˈb ɛ d a
berbicara	b ə r b i t͡ʃ a r a
berdarah	b ə r ˈd a r a h
berdasar	b ə r ˈd a s a r
berhenti	b ə r h ə n ˈt i
beri	b ə r i
berida	b ə . r i . d a
berjalan	b ə r ˈd͡ʒ a l a n
berjibaku	b ə r . d͡ʒ i . b a . k u
berjudi	b ə r ˈd͡ʒ u d i
berkap	b ə r ˈk a p̚
berkap	b ə r ˈk a p̚
berkeadilan	b ə r k ə a ˈd ɪ l a n
berkeberatan	b ə r k ə b ə ˈr a t a n
berkembang	b ə r k ə m ˈb a ŋ
berkenan	b ə r . k ə . ˈn a n
berketombe	b ə r k ə ˈt ɔ m b e
berlibur	b ə r ˈl i b ʊ r
berontak	b ə ˈr ɔ n t a k
berpulang	b ə r ˈp u l a ŋ
bersama	b ə r s a m a
bersedia	a b o n ə m ɛ n
bersemuka	b ə r . s ə . ˈm u . k a
bersenandung	b ə r s ə ˈn a n d ʊ ŋ
bersih	b ə r s ɪ h
bersihan	b ə r . ˈs ɪ h . a n
bersuasana	b ə r . ˈs u . w ä . r ä
bertambah	b ə r ˈt a m b a h
berteori	b ə r t e o r i
beruang	b ə ˈr u a̯ ŋ
beruang	b ə r ˈu a̯ ŋ
berubah	b ə r ˈʊ b a h
beruk	b ə ˈr u k
berus	b ə ˈr ʊ s
besar	b ə ˈs a r
besikal	b ə ˈs i . k a l
beskal	b ə s ˈk a l
besok	ˈb e s ɔ ʔ̚
bestari	b ə s t a r i
beta	b e . t a
betah	b ə ˈt a h
Betawi	b ə t a w i
betik	b ə . ˈt ɪ k
beton	b ə . t o n
betonase	b ə t o ˈn a s ə
bhayangkara	b a . j a ŋ . k a . r a
bia	b i a
biadab	b i ˈa d a p̚
biara	b i . a . r a
biaya	b i a j a
Bibel	ˈb i . b ə l
bibi	ˈb i b i
bibir	ˈb ɪ . b ɪ r
bibit	ˈb i b ɪ t̚
bicara	b i t͡ʃ a r a
bidadari	b i . d a . d a . r i
bidak	b i d a k
bidan	b i . d a n
bidang	ˈb i . d a ŋ
bihun	b i . h u n
bijak	b i . d͡ʒ a k
bijaksana	b i . d͡ʒ a k . s a . n a
biji	ˈb i d͡ʒ i
bikini	b i ˈk i n i
biksu	b i k . s u
biku	b i . k u
bila	b i . l a
bilang	ˈb i l a ŋ
bilangan	b i ˈl a ŋ a n
bilateral	b i . l a . t ə . ˈr a l
bilier	b i ˈl i ɛ r
biliun	b i ˈl i ʊ n
Bima	ˈb i m a
bina	ˈb i n a
binasa	b i . n a . s a
binatang	b i ˈn a t a ŋ
binawah	b i ˈn a w a h
bineka	b i . ˈn e . k a
biner	ˈb i n ɛ r
bingar	ˈb i ŋ a r
bintara	b i n . t a . r a
binturung	b ɪ n ˈt u r ʊ ŋ
bioindikator	b i o ɪ n d i ˈk a t ɔ r
bioinformatika	b i o . ɪ n . f ɔ r . m a . ˈt i . k a
biologis	b i o ˈl o ɡ ɪ s
bioskop	b i . o . s k o p
biostatika	b i . o . s t a . ˈt i . k a
BIPA	ˈb i p a
biro	b i . r o
bisban	ˈb ɪ s b a n
biwara	b i . ˈw a . r a
blangko	b ə̆ l a ŋ k o
blek	b l ɛ k
blumbak	ˈb l ʊ m b a k̚
BNN	b e ˈɛ n ɛ n
BNPT	b e ɛ n ˈp e t e
bobot	ˈb o . b ɔ t̚
bobrok	b o . b r ɔ k
bodo	ˈb o . d o
bodoh	ˈb o d ɔ h
bodok	ˈb o d ɔ k̚
bogi	ˈb o . ɡ i
bohong	b o . h o ŋ
boikot	ˈb o i̯ k ɔ t̚
boleh	b o . l e h
bolu	ˈb o l u
bon	ˈb ɔ n
borang	ˈb ɔ r a ŋ
bordil	b o r d ɪ l
borgol	ˈb ɔ r ɡ ɔ l
borok	ˈb ɔ . r ɔ k̚
bozah	ˈb o z a h
bradikardia	b r a . d i . ˈk a r . d i a̯
brahmana	b r a h ˈm a n a
bramacorah	b r a m a ˈt͡ʃ o r a h
brankar	b r a n k a r
bravo	ˈb r a . v o
bruder	b r u d ə r
buana	b u a̯ . n a
bubar	ˈb u b a r
bubuk	ˈb u b u k
budak	b u . d a k
budak	b u . d a ʔ
budaya	b u . d a . j a
budi	b u . d i
budiman	b u . d i . m a n
bugil	ˈb u ɡ ɪ l
bujangga	b u . d͡ʒ a ŋ . ɡ a
buka	ˈb u k a
bukak	ˈb u k a k̚
bukak	ˈb u k a ʔ
bukan	ˈb u k a n
bukti	b u k . t i
buku	ˈb u k u
bulan	ˈb u l a n
bulbul	ˈb ʊ l b ʊ l
Bulgaria	b ʊ l ˈɡ a r i a̯
bulu	ˈb u . l u
buluh	ˈb u l ʊ h
bumbung	ˈb u m b u ŋ
bumi	b u m i
bumiputra	b u . m i . p u . t r a
bumiputra	b u . m i . p u . t ə . r a
buncis	b u n . t͡ʃ ɪ s
bunda	ˈb ʊ n d a
bundel	ˈb ʊ n d ə l
bundir	b u n . d i r
bunga	ˈb u ŋ a
bungkus	ˈb ʊ ŋ k ʊ s
bungsu	b u ŋ s u
bungsut	ˈb ʊ ŋ s ʊ t̚
buni	ˈb u n i
bunting	b ʊ n . t ɪ ŋ
bunuh	ˈb u n ʊ h
bupati	b u . p a . t i
buron	b u r ɔ n
buruh	ˈb u r u h
buruk	ˈb u r u k
burung	ˈb u . r ʊ ŋ
bus	ˈb ʊ s
busa	b u . s a
busana	b u . s a . n a
bushido	b u s . h i . d o
bushido	b u . ʃ i . d o
bustan	ˈb ʊ s t a n
busyido	b u . ʃ i . d o
buta	b u . t a
butala	b u . t a . l a
butana	b u . t a . n a
butun	ˈb u t u n
c	t͡ʃ e
c	s e
c	t ʃ
C	t͡ʃ e
C	s e
C	t ʃ
cabai	ˈt͡ʃ a b a j
cabai	t͡ʃ a . b e
cabai	t͡ʃ a . b e ʔ
cabul	ˈt͡ʃ a . b ʊ l
cabut	t͡ʃ a b ʊ t
cadang	ˈt͡ʃ a . d a ŋ
cadar	t͡ʃ a . d a r
cagar	ˈt͡ʃ a . ɡ a r
cahaya	t͡ʃ a ˈh a j a
cairan	t͡ʃ a ɪ r a n
cakalang	t͡ʃ a . ˈk a . l a ŋ
cakap	t͡ʃ a . k a p
cakra	t͡ʃ a . k ə . r a
cakram	t͡ʃ a k . r a m
cakrawala	t͡ʃ a k . r a . w a . l a
cakrawati	t͡ʃ a k . r a . w a . t i
cakupan	t͡ʃ a . ˈk ʊ p . a n
calak	ˈt͡ʃ a l a ʔ
calir	ˈt͡ʃ a l ɪ r
Callista	ˈk a l i s t a
calon	ˈt͡ʃ a . l o n
cam	ˈt͡ʃ a m
camat	t͡ʃ a m a t̚
campur	t͡ʃ a m . p ʊ r
canang	ˈt͡ʃ a . n a ŋ
candra	t͡ʃ a n . d r a
canggih	t͡ʃ a ŋ . ɡ i h
cangklek	ˈt͡ʃ a ŋ k l e k̚
canoyu	t͡ʃ a . n o . j u
cantik	t͡ʃ a n . t i k
capung	ˈt͡ʃ a p ʊ ŋ
cara	t͡ʃ a . r a
cari	t͡ʃ a . r i
catam	ˈt͡ʃ a t a m
catat	ˈt͡ʃ a t a t̚
catur	t͡ʃ a . t u r
catur	t͡ʃ a . t u r
cecan	t͡ʃ ə . t͡ʃ a n
cecer	ˈt͡ʃ e . t͡ʃ ɛ r
cecer	t͡ʃ ə . ˈt͡ʃ ə r
cedera	t͡ʃ ə . d ə . r a
cela	t͡ʃ ə . l a
celaan	t͡ʃ ə ˈl a a n
celaka	t͡ʃ ə . l a . k a
celapa	t͡ʃ ə . l a . p a
cemani	t͡ʃ ə . m a . n i
cempaka	t͡ʃ ə m . p a . k a
cenangga	t͡ʃ ə . n a ŋ . ɡ a
cendala	t͡ʃ ə n . d a . l a
cendana	t͡ʃ ə n . d a . n a
cendera	t͡ʃ ə n d ə r a
cenderasa	t͡ʃ ə n . d ə . r a . s a
cenderawasih	t͡ʃ ə n . d ə . r a . w a . s i h
cengkerama	t͡ʃ ə ŋ . k ə . r a . m a
cengkerawak	t͡ʃ ə ŋ . k ə . r a . w a k
cerana	t͡ʃ ə . r a . n a
cerca	t͡ʃ ə r . t͡ʃ a
ceria	t͡ʃ ə . r i a
cerita	t͡ʃ ə . r i . t a
ceroboh	ˈt ʃ ə . r o . b o h
cerpelai	t͡ʃ ə r ˈp ə l a j
cerutu	t͡ʃ ə ˈr u t u
cetera	t͡ʃ ə . t ə . r a
cetera	t͡ʃ ə . t ə . r a
China	ˈt͡ʃ ɪ n a
chindo	t͡ʃ i n d o
cilik	ˈt͡ʃ i . l ɪ k
cita	t͡ʃ i . t a
citra	t͡ʃ i t . r a
citra	t͡ʃ i . t r a
ciu	t͡ʃ i u
coba	ˈt͡ʃ o b a
cogan	t͡ʃ o . ɡ a n
cokelat	t ʃ ɔ . k ə ˈl a t
coker	ˈt͡ʃ o k ə r
coli	t͡ʃ o . l i
contoh	ˈt͡ʃ ɔ n t ɔ h
cowok	t ʃ o . w o ʔ
cuaca	t͡ʃ u . a . t͡ʃ a
cuat	ˈt͡ʃ u . a t
cucu	ˈt͡ʃ u . t͡ʃ u
cuek	c u e ʔ
cuitan	t͡ʃ u ˈɪ t̚ a n
cuka	t͡ʃ u . k a
cula	t͡ʃ u . l a
cultuurstelsel	k ʊ l t ʊ r s t ɛ l s ə l
cuma	t͡ʃ u . m a
cupido	t͡ʃ u ˈp i d o
curah	ˈt͡ʃ u . r a h
curi	t ʃ u . r i
curiga	t͡ʃ u . r i . ɡ a
d	d e
d	d
D	d e
D	d
dada	ˈd ä . d ä
dadih	d a . d i h
daerah	d a ˈɛ r a h
Daffa	ˈd a f a
daidan	d a i . d a n
daidanco	d a i . d a n . t͡ʃ o
daitia	d a i . t i a
daksina	d a k . s i . n a
daku	d a k u
dakwaan	d a ʔ ˈw a a n
dalam	ˈd a l a m
damkar	d a m . k a r
dampak	ˈd a m p a k̚
dan	d a n
dan	d a n
dana	d a . n a
danau	d a n a u̯
dansa	d a n . s a
danta	d a n . t a
darah	ˈd a r a h
daras	d a r a s
darat	ˈd a r a t
dargah	ˈd a r ɡ a h
dari	d a . r i
daring	ˈd a r ɪ ŋ
darji	ˈd a r d͡ʒ i
darma	d a r . m a
darwis	ˈd a r w ɪ s
dasar	ˈd a s a r
daster	ˈd a s t ɛ ɾ
datang	ˈd a t a ŋ
datar	ˈd a t a r
datu	ˈd a t u
Datu	ˈd a t u
datuk	ˈd a t ʊ k̚
daun	ˈd a ʊ n
daur	ˈd a ʊ r
dawat	ˈd a w a t̚
dawet	ˈd a . w ə t
daya	d a j a
dayah	ˈd a j a h
deaminasi	d e a m i ˈn a s i
debu	d ə ˈb u
debus	d ə ˈb ʊ s
dedak	d ə . ˈd a k
deduksi	d e ˈd ʊ k s i
deduktif	d e ˈd ʊ k t ɪ f
deeskalasi	d e e s k a ˈl a s i
defek	ˈd e f ɛ k̚
defekasi	d e f e ˈk a s i
defenisi	d e . f e . n i . s i
defensi	d e ˈf ɛ n s i
defensif	d e ˈf e n s ɪ f
defile	d e ˈf i l e
definitif	d e f i ˈn i t ɪ f
deflasi	d e ˈf l a s i
defleksi	d e . ˈf l ɛ k . s i
deforestasi	d e . f o . r ə s . ˈt a . s i
deformasi	d e f ɔ r ˈm a s i
degenerasi	d e ɡ e n ə ˈr a s i
degeneratif	d e ɡ e n ə ˈr a t ɪ f
degradasi	d e ɡ r a ˈd a s i
dehidrasi	d e h i ˈd r a s i
dekan	d e k a n
dekan	d ə k a n
dekat	d ə ˈk a t
dekomposisi	d e k ɔ m p o ˈs i s i
delesi	d e . l e . s i
delman	ˈd e l . m a n
demang	d ə ˈm a ŋ
demografi	d e m o ˈɡ r a f i
demografis	d e m o ˈɡ r a f ɪ s
demonetisasi	d e m o n e t i ˈs a s i
denaturasi	d e n a t u ˈr a s i
dengan	d ə . ŋ a n
dengar	d ə . ŋ a r
Denmark	ˈd ɛ n m a r k
densitas	d ɛ n ˈs i t a s
departementalisasi	d ə p a r t ə m ɛ n t a l i ˈs a s i
deplesi	d e ˈp l e s i
depok	ˈd e . p ɔ k
depresan	d e ˈp r ɛ s a n
depresi	d e ˈp r ɛ s i
depresiasi	d e . p r e . ˈs i a . s i
derita	d ə . r i . t a
desalinasi	d e . s a . l i . ˈn a . s i
deselerasi	d e s ɛ l ə ˈr a s i
Desember	d e . ˈs ɛ m . b ə r
desistor	d e ˈs ɪ s t ɔ r
detail	d ə ˈt a ɪ l
detail	d i ˈt ɛ l
determinan	d e . t ɛ r . ˈm i . n a n
determinasi	d e . t ɛ r . m i . ˈn a . s i
determinisme	d e . t ɛ r . m ɪ n . ˈɪ s . m ə
detoksifikasi	d e t ɔ k̚ s i f i ˈk a s i
devisa	d e . ˈv i . s a
devosi	d e v o s i
dewa	d ɛ . w a
dewan	ˈd ɛ w a n
dewana	d ɛ ˈw a n a
di	d i
diagram	d i . a . ˈɡ r a m
diaken	d i a k ə n
diakon	d i a k o n
diam	d i . a m
diberhentikan	d i b ə r h ə n ˈt i k a n
dicari	d i ˈt͡ʃ a r i
dicatat	d i ˈt͡ʃ a t a t̚
didik	d i d ɪ ʔ
diet	ˈd i e t̚
difabel	d i ˈf a b ə l
diferensial	d i . f e . r ɛ n . ˈs i . a l
difraksi	d i . ˈf r a k . s i
difusi	d i ˈf u s i
digali	ˈd i . ɡ a l i
digdaya	d i ɡ . d a . j a
dijelaskan	d i d͡ʒ ə ˈl a s k a n
dikau	d i k a u̯
dikotomi	d i . k o . ˈt o . m i
dikti	ˈd ɪ k̚ t i
dilah	ˈd i l a h
dimakan	ˈd i . m a k a n
dinamika	d i n a ˈm i k a
dinamis	d i ˈn a m ɪ s
dingin	d i ŋ ɪ n
dinyatakan	d i ɲ a ˈt a k a n
diode	d i ˈo d ə
dipantau	d i ˈp a n t a u̯
diperburuk	d i p ə r ˈb u r ʊ k̚
diperkeruh	d i p ə r k ə ˈr ʊ h
diperkokoh	d i p ə r ˈk o k ɔ h
dipimpin	d i ˈp i m p i n
diploma	d i ˈp l o m a
dirgahayu	d i r . ɡ a . h a . j u
diri	d i . r i
disebar	d i s ə ˈb a r
diskontinuitas	d ɪ s . k ɔ n . t i . n u . ˈi . t a s
diskotek	d i s . k o . t e k
disposisi	d i s . p o . s i . s i
distribusi	d ɪ s t r i ˈb u s i
ditangkap	d i ˈt a ŋ k a p̚
ditemukan	d i t ə ˈm u k a n
ditografi	d i t o ˈɡ r a f i
ditolak	d i ˈt o l a k̚
DIY	d e i ˈj e
doa	d o a
dohyo	d o . hʲ o
dohyo	d ɔ . xʲ ɔ
dojo	d o . d͡ʒ o
dokter	ˈd ɔ k t ə r
doktor	d ɔ k . t ɔ r
dokumen	d o ˈk u m ɛ n
dokumentalis	d o k u m ɛ n ˈt a l ɪ s
dokumentasi	d o k u m ɛ n ˈt a s i
dokumenter	d o k u ˈm ɛ n t ɛ r
dokumentografi	d o k u m ɛ n t o ˈɡ r a f i
dolar	ˈd o l a r
dolfin	ˈd ɔ l . f i n
dom	ˈd ɔ m
donasi	d o . n a . s i
dong	ˈd ɔ ŋ
dongkrak	ˈd ɔ ŋ k r a k̚
dorama	d o . ˈr a . m a
dorna	d o r n a
dorong	d o r o ŋ
dorongan	d ɔ ˈr ɔ ŋ a n
dosa	d o s a
dosen	d o . s ɛ n
dosin	ˈd o . s i n
doyo	d o . j o
dramatis	d r a ˈm a t ɪ s
dua	ˈd u w ä
duane	d u ˈa n ə
dugong	ˈd u ɡ ɔ ŋ
duit	d u . i t
duk	d ʊ k̚
duka	d u . k a
duktus	ˈd ʊ k̚ t ʊ s
dukuh	ˈd u . k ʊ h
dukung	ˈd u . k ʊ ŋ
duli	d u l i
dulu	d u . l u
dunia	d u . n i . a
dupa	d u . p a
duren	ˈd u . r ɛ n
durhaka	d ʊ r ˈh a k a
duri	ˈd u . r i
durian	d u . ˈr i . a n
dusta	ˈd u s t a
dusun	ˈd u . s ʊ n
duta	d u . t a
duyung	ˈd u j ʊ ŋ
e	e
e	e
e	ɛ
e	ə
E	e
E	e
E	ɛ
E	ə
ecer	ˈɛ t͡ʃ ɛ r
eceran	ˈɛ t͡ʃ ɛ r a n
eco	ˈe . t͡ʃ o
eco	ˈe . t͡ʃ ɔ
edamame	e d a ˈm a . m e
edaran	e . ˈd a r . a n
edema	ˈe d e m a
edisi	ˈɛ d i s i
editor	ˈɛ d i t ɔ r
efek	ɛ . f ɛ k
efektif	ˈɛ f ɛ k̚ t ɪ f
eigendom	e i . ɡ ə n . d o m
eka	e . k a
ekaristi	ɛ k a r i s t i
eklips	ɛ k . l i p s
ekonomis	ɛ k o ˈn o m ɪ s
ekor	ɛ . k o r
ekor	ɛ . k ɔ r
eksem	ˈɛ k . s ɛ m
eksentrik	ɛ k . ˈs ɛ n . t r ɪ k
ekshibitor	ɛ k s h i ˈb i t ɔ r
eksim	ˈɛ k . s ɪ m
eksipien	ɛ k . s i . ˈp i . ɛ n
ekskresi	ɛ k s ˈk r ɛ s i
ekskursi	ɛ k s ˈk ʊ r s i
eksper	ɛ k ˈs p ɛ r
eksperimen	ɛ k s p ɛ ˈr i m ɛ n
eksperimental	ɛ k s . p ə . r i . ˈm ɛ n . t a l
eksperimental	ɛ k s . p ɛ . r i . ˈm ɛ n . t a l
eksplikatif	ɛ k s p l i ˈk a t ɪ f
eksplorasi	ɛ k s p l o ˈr a s i
eksponen	ɛ k s . ˈp o . n ɛ n
ekstrapolasi	ɛ k s . t r a . p o . ˈl a . s i
ekstrinsik	ɛ k s . ˈt r ɪ n . s ɪ k
elang	ˈə l a ŋ
elang	ˈe l a ŋ
elang	ˈe l a ŋ
elektrik	ɛ l ɛ k . t r ɪ k
elektris	ɛ l ɛ k . t r ɪ s
elektroda	ɛ . l ɛ k . t r o . d a
elektrode	ɛ . l ɛ k . t r o . d e
elektrode	ɛ . l ɛ k . t r o . d ə
elektromagnetisme	ɛ l ɛ k t r o m a k n ɛ t ˈɪ s m ə
eliminasi	e . l i . m i . ˈn a . s i
eling	ˈe . l ɪ ŋ
elipsis	e . ˈl ɪ p . s ɪ s
emas	ə m a s
emban	ə m ˈb a n
embrio	ɛ m ˈb r i o
emoji	e . m o . d͡ʒ i
empal	ə m . ˈp a l
empati	ɛ m ˈp a t i
empedal	ə m p ə d a l
empedu	ə m p ə ˈd u
empiris	ɛ m ˈp i r ɪ s
empu	ə m ˈp u
endap	ə n . ˈd a p
endapan	ə n ˈd a p a n
endorsemen	ɛ n . d ɔ r . s ə . ˈm ɛ n
enggak	ə ŋ ˈɡ a k
engkau	ə ŋ k a u̯
engsel	ˈɛ ŋ s ɛ l
ensambel	ɛ n ˈs a m b ə l
ensiklik	e n s i k l i k
ensiklopedi	ɛ n s i k l o ˈp ɛ d i
ente	ˈɛ n t ɛ
entot	ɛ n . t o t
enzim	ˈɛ n . z ɪ m
epitel	ˈɛ p i t ɛ l
epolet	ˈɛ p o l ɛ t̚
epos	ˈe . p ɔ s
erat	ə . r a t
ergonomi	e r ɡ o ˈn o m i
ergonomis	e r ɡ o ˈn o m ɪ k
erotis	ˈɛ r o t ɪ s
erti	ə r . t i
es	ɛ s
esa	ə . s a
esa	e . s a
esai	ə . ˈs a i̯
eskar	ˈɛ s . k a r
estafet	ɛ s . t a . f ɛ t
ester	ˈɛ s . t ə r
estetik	ɛ s ˈt ɛ t ɪ k̚
estetis	ɛ s ˈt ɛ t ɪ s
Estonia	e s ˈt o n i a̯
etana	e . t a . n a
eter	ˈɛ t ə r
etik	ˈɛ t ɪ k
etika	ˈɛ t i k a
etis	ˈɛ t ɪ s
etude	e t u d ɛ
eutanasia	e u t a n a ˈs i a
evaluasi	ɛ v a l u ˈa s i
f	ɛ f
f	f
F	ɛ f
F	f
fabrikasi	f a b r i ˈk a s i
fajar	ˈf a d͡ʒ a r
fakir	ˈf a k ɪ r
faktor	ˈf a k̚ t ɔ r
falak	ˈf a l a k̚
falseto	f a l s é t o
fantasi	f a n ˈt a s i
fantastis	f a n ˈt a s t ɪ s
fantosmia	f a n ˈt ɔ s m i a̯
faring	ˈf ä . r i ŋ
farmasi	f a r . m a . s i
farsakh	ˈf a r s a x
fasakh	ˈf a s a ʔ
fatamorgana	f a t a m ɔ r ˈɡ a n a
fatwa	ˈf a t . w a
favorit	f a ˈv o r i t
Februari	f ɛ b r u ˈa r i
fenomenologi	f e . n o . m e . n o . ˈl o . ɡ i
feodal	f e ˈo d a l
feodalisme	f e o d a l ˈɪ s m ə
fermentasi	f e r m e n ˈt a s i
feses	ˈf ɛ s ɛ s
fiat	ˈf i a t
fiksasi	f ɪ k . ˈs a . s i
filamen	f i . ˈl a . m ɛ n
film	ˈf ɪ l ə m
film	ˈp e l ə m
finansial	f i n a n ˈs i a l
Finlandia	f ɪ n ˈl a n d i a̯
firaun	f i r . a . u n
fiskal	ˈf ɪ s . k a l
flan	ˈf l a n
fleksibel	f l ɛ k . ˈs i . b ə l
flop	ˈf l ɔ p̚
fluida	f l u ˈi d a
fluks	ˈf l ʊ k s
FMIPA	e f . m i . p a
folder	ˈf ɔ l d ə r
folklor	ˈf ɔ l ʔ . l ɔ r
fonem	ˈf o n ɛ m
fonemis	f o ˈn e m ɪ s
fonetik	f o ˈn ɛ t ɪ k̚
formatif	f ɔ r . ˈm a . t ɪ f
formulir	f o r ˈm u l ɪ r
fotoelektrisitas	f o t o ɛ l ɛ k̚ t r i ˈs i t a s
fotosel	f o ˈt o s ɛ l
frater	f r a t ə r
frekuensi	f r e k u ˈɛ n s i
frekwensi	f r e k . w ɛ n . s i
frekwensi	f r e . k w ɛ n . s i
g	ɡ e
g	ɡ
G	ɡ e
G	ɡ
gabah	ˈɡ a b a h
gabungan	ɡ a ˈb ʊ ŋ a n
gada	ɡ a d a
gading	ɡ a . d i ŋ
gaga	ˈɡ a . ɡ a
gagah	ˈɡ a . ɡ a h
gagak	ˈɡ a . ɡ a ʔ
gagal	ˈɡ a . ɡ a l
gagang	ˈɡ a . ɡ a ŋ
gagu	ˈɡ a ɡ u
gaharu	ɡ a h a r u
gajah	ˈɡ a d͡ʒ a h
gakari	ɡ a . k a . r i
gala	ɡ a l a
gala	ɡ a l a
galak	ɡ a . l a k
galat	ˈɡ a l a t̚
galer	ɡ a . l e r
gali	ˈɡ a l i
galib	ˈɡ a l ɪ p̚
galuh	ɡ a l u h
gamang	ˈɡ a m a ŋ
gambus	ˈɡ a m . b ʊ s
gampar	ɡ a m . p a r
gandar	ˈɡ a n . d a r
gandeng	ˈɡ a n . d ɛ ŋ
gandu	ˈɡ a n d u
gang	ɡ a ŋ
gangsa	ˈɡ a ŋ . s a
ganjar	ˈɡ a n d͡ʒ a r
ganjaran	ɡ a n ˈd͡ʒ a r a n
ganteng	ɡ a n ˈt ə ŋ
ganti	ɡ a n . t i
gantung	ˈɡ a n . t ʊ ŋ
gap	ˈɡ a p
gap	ˈɡ ɛ p
gapura	ɡ a p u r a
garangan	ɡ a ˈr a ŋ a n
garansi	ɡ a ˈr a n s i
garuda	ɡ a ˈr u d a
gastrointestinal	ɡ a s . t r o . ɪ n . t ɛ s . ˈt i . n a l
gatal	ɡ a . t a l
gaul	ɡ a u l
gawang	ˈɡ a w a ŋ
gay	ˈɡ a y
gayung	ɡ a j u ŋ
gaz	ˈɡ a z
gejala	ɡ ə . ˈd͡ʒ a . l a
gelak	ɡ ə ˈl a k
gelak	ɡ ə ˈl a ʔ
gelap	ɡ ə ˈl a p̚
gelar	ɡ ə . ˈl a r
gelis	ɡ ə . ˈl ɪ s
gelita	ɡ ə l i t a
gelora	ɡ ə l o r a
gelut	ɡ ə . ˈl ʊ t
geman	ɡ ə ˈm a n
gempa	ɡ ə m ˈp a
gempita	ɡ ə m . p i . t a
gemuk	ˈɡ ə m ʊ ʔ
gen	ˈɡ ɛ n
gender	ˈɡ ɛ n d ə r
gender	ɡ ə n ˈd ɛ r
genderuwo	ɡ ə n . d ə . ˈr u . w o
genderuwo	ɡ ə n . d ə . ˈr u . w ɔ
generator	ɡ e n ə ˈr a t ɔ r
geng	ɡ ɛ ŋ
genosida	ɡ e n o ˈs i d a
genta	ɡ ə n t a
Georgia	ɡ e ɔ r ˈɡ i a
geostasioner	ɡ e o s t a s i ˈo n ɛ r
gerah	ɡ ə ˈr a h
gerbang	ɡ ə r . ˈb a ŋ
gereja	ɡ ə ˈr ɛ d͡ʒ a
gergasi	ɡ ə r . ˈɡ a . s i
gerha	ɡ ə r . h a
gerhana	ɡ ə r . h a . n a
geriatri	ɡ e . r i . ˈa . t r i
gering	ɡ ə . ˈr ɪ ŋ
gerus	ɡ ə . ˈr ʊ s
getar	ɡ ə . ˈt a r
geulis	ɡ ɘ . ˈl ɪ s
GGL	ɡ e . ɡ e . ɛ l
giat	ˈɡ i a t̚
gigantisme	ɡ i ɡ a n ˈt ɪ s m ə
gigi	ˈɡ i . ɡ i
gigit	ˈɡ ɪ . ɡ ɪ t̚
gilap	ˈɡ i l a p̚
gilik	ˈɡ i l ɪ k̚
giling	ˈɡ i l ɪ ŋ
gimnasium	ɡ ɪ m n a ˈs i ʊ m
giri	ɡ i . r i
giro	ɡ i r o
gita	ɡ i . t a
gletser	ˈɡ l ɛ t s ə r
glikogen	ɡ l i ˈk o ɡ ɛ n
globalisme	ɡ l o b a l ˈɪ s m ə
go	ɡ o
goban	ɡ o . b a n
golf	ˈɡ o l ĕ f
gongyo	ɡ o n . ɡʲ o
gongyo	ɡ ɔ n . ɡʲ ɔ
gongyo	ɣ o n . ɣʲ o
gongyo	ɣ ɔ n . ɣʲ ɔ
goniometri	ɡ o . n i . o . ˈm e . t r i
goreng	ˈɡ o r ɛ ŋ
graf	ˈɡ r a f
graha	ɡ r a . h a
grahita	ɡ r a . h i . t a
granat	ɡ r a . n a t̚
granit	ˈɡ r a n ɪ t̚
gravir	ˈɡ r a . v ɪ r
gravir	ˈɡ r a . f ɪ r
gravitasi	ɡ r a v i ˈt a s i
greha	ɡ r ə . h a
gresik	ɡ r ə ˈs ɪ k̚
grup	ˈɡ r ʊ p̚
gua	ɡ u a
gubernur	ɡ u b ə r n ʊ r
gudang	ɡ u d a ŋ
gugur	ˈɡ u . ɡ ʊ r
gugus	ˈɡ u ɡ ʊ s
gula	ˈɡ u . l a
gulana	ɡ u l a n a
gulud	ˈɡ u l ʊ t̚
guna	ɡ u n a
gundik	ˈɡ u n d i ʔ
gunseibu	ɡ u n . s e i . b u
gunseikan	ɡ u n . s e i . k a n
gunung	ˈɡ u n u ŋ
gurami	ɡ u . ˈr a . m i
guru	ɡ u . r u
gusi	ˈɡ u . s i
h	h a
h	h
H	h a
H	h
Habel	h a b e l
Habil	h a b ɪ l
habitat	h a ˈb i t a t̚
habituasi	h a b i t u ˈa s i
habitus	h a ˈb i t ʊ s
had	ˈh a t
hadap	ˈh a d a p̚
hadas	ˈh a d a s
hadiah	h a ˈd i j a h
hadir	h a . d ɪ r
hadirat	h a ˈd i r a t̚
hadirin	h a ˈd i r ɪ n
hai	h a ɪ
haiku	h a i . k u
hakam	ˈh a . k a m
hakim	ˈh a k ɪ m
hal	h a l
halal	ˈh a l a l
halaman	h a . l a . m a n
halia	h a l i a
halusinasi	h a l u s i ˈn a s i
hama	ˈh a m a
hamba	h a m . b a
hambatan	h a m ˈb a t a n
hampir	h a m . p i r
hancur	ˈh a n t͡ʃ ʊ r
handal	h a n d a l
handasah	h a n ˈd a s a h
handelar	h a n ˈd ə l a r
handschoen	h a n . s ə k ʊ n
handschoen	h a n t̚ s k ʊ n
handuk	h a n d ʊ k̚
hangat	h a . ŋ a t
hantu	ˈh a n . t u
hanya	h a . ɲ a
hanzi	h a n . z i
hara	ˈh a . r a
harap	h a . r a p
harapan	h a . ˈr a p . a n
harga	h a r . ɡ a
harimau	h a ˈr i m a u̯
harmonisasi	h a r . m o . n i . ˈs a . s i
harta	h a r . t a
harus	h a . r ʊ s
hasad	ˈh a s a t̚
hasta	h a s . t a
hasyis	ˈh a ʃ ɪ s
hati	h a . t i
hatta	h a t . t a
haus	ˈh a . ʊ s
hawan	h a w a n
hawu	ˈh a w u
hayat	h a . j a t̚
hayati	h a . j a . t i
hechting	h ɛ k̚ t ɪ ŋ
hedon	h e . d o n
hedonisme	h e . d o . n i s . m ə
heiho	h e i . h o
heksana	h ɛ k . s a . n a
heksana	h ɛ k s . a . n a
helikopter	h e . l i . ˈk ɔ p . t ə r
hembus	h ə m ˈb u s
hemisfer	h e ˈm i . s f ɛ r
hendak	h ə n ˈd a k̚
heng	h ɛ ŋ
heng	h ɛ ŋ
hentai	h ɛ n . t a i̯
henti	h ə n̪ . ˈt̪ i
heptana	h e p . t a . n a
herbarium	h ɛ r . b a . ˈr i . ʊ m
herbisida	h ɛ r b i ˈs i d a
heterogen	h e . t e . ˈr o . ɡ ɛ n
heterogenitas	h e . t e . r o . ɡ e . ˈn i . t a s
heterotrof	h e . t e . r o . t r o f
hewan	ˈh e w a n
hewani	h e ˈw a n i
HI	h a i
hibah	ˈh i b a h
hibrida	h i ˈb r i d a
hidayah	h i ˈd a j a h
hidrogen	h i d r o ɡ ɛ n
hidrokarbon	h i . d r o . ˈk a r . b ɔ n
hidung	ˈh i . d u ŋ
hidup	ˈh i . d ʊ p̚
hierarki	h i e r a r k i
hijau	ˈh i d͡ʒ a w
hijrah	h i d͡ʒ r a h
hijriah	h i d͡ʒ r i a h
hikmah	h i k m a h
hikmat	ˈh ɪ k m a t̚
hilang	h i l a ŋ
himpunan	h ɪ m ˈp ʊ n a n
hina	h i n a
hindar	ˈh ɪ n . d a r
hiperaktivitas	h i . p ə r . a k . t i . ˈv i . t a s
hipernim	h i p ə r ˈn ɪ m
hipospadia	h i p o ˈs p a d i a̯
hipotenusa	h i p o t ə ˈn u s a
hipotesa	h i . p o . ˈt e . s a
hitung	ˈh i t ʊ ŋ
hiu	ˈh i . u
holistis	h o . ˈl ɪ s . t ɪ s
homeostasis	h o m e o ˈs t a s ɪ s
homo	h o . m o
hongbao	h o ŋ . b a o
honje	ˈh ɔ n d͡ʒ e
honji	h o n . d͡ʒ i
hop	h o p
hopagen	h o p . a . ɡ ɛ n
hopbiro	h o p . b i . r o
hormat	ˈh ɔ r m a t̚
hosti	h o s t i
hukum	ˈh u . k ʊ m
hukuman	h u ˈk u . m a n
hulu	h u . l u
huma	h u m a
humanis	h u . ˈm a . n ɪ s
humanisme	h u . m a . ˈn ɪ s . m ə
huni	ˈh u n i
huruf	ˈh u r ʊ f
hutan	ˈh u t a n
i	i
i	i
i	ɪ
I	i
I	i
I	ɪ
ia	ˈi a̯
ialah	i a l a h
iba	i . b a
ibadah	i . b a . d a h
ibadat	i . b a . d a t
ibarat	ˈɪ b a r a t̚
Ibrani	i ˈb r a n i
ibukota	i . b u . k o . t a
idap	ˈɪ d a p̚
idealisme	i . d e . a l . ˈɪ s . m ə
idem	ˈɪ . d ə m
idem	ˈɪ . d ɛ m
ideologi	i d e o ˈl o ɡ i
idep	ˈɪ d ə p̚
ider	i d ə r
idih	ʔ i . d i h
Iduladha	i d u l ˈa d a
iga	ˈɪ ɡ a
ijazah	ˈɪ d͡ʒ a z a h
ikan	i k a n
ikatan	ˈɪ k a t a n
ikebana	i . k e . b a . n a
ikhlas	i x l a s
ikhlas	i k l a s
ikhlas	i h l a s
iklan	ˈɪ k l a n
iklim	i k . l ɪ m
ikonik	i k o . n ɪ k
ikonis	i k o . n ɪ s
iktibar	ɪ ʔ ˈt i b a r
iktidal	ɪ ʔ ˈt i d a l
ilah	ˈɪ l a h
ilat	ˈɪ l a t̚
ilham	ˈɪ l h a m
ilopasia	ɪ l o ˈp a s i a̯
ilustrasi	ɪ l ʊ s ˈt r a s i
imam	i . m a m
imamah	i m a . m a h
imamat	i m a . m a t
iman	ˈi . m a n
impas	ˈɪ m p a s
imperial	ɪ m p ɛ ˈr i a l
imperialis	ɪ m p ɛ r i ˈa l ɪ s
imperialisme	ɪ m p ɛ r i a ˈl ɪ s m ə
imperialistik	ɪ m p ɛ r i a ˈl ɪ s t ɪ k̚
imperium	ɪ m p e ˈr i ʊ m
implementasi	ɪ m . p l ə . m ɛ n . ˈt a . s i
impresum	ɪ m ˈp r ɛ s ʊ m
imprimatur	i m p r i m a t u r
impuls	ˈɪ m . p ʊ l s
impulsivitas	ɪ m . p ʊ l . s i . ˈv i . t a s
IMT	i ˈɛ m t e
inang	i n a ŋ
incung	ˈɪ n t͡ʃ ʊ ŋ
indekos	i n d ə ˈk ɔ s
indeks	ˈɪ n d ɛ k s
independen	i n . d ə . p ɛ n . d ə n
indikator	ɪ n d i ˈk a t ɔ r
individualisme	ɪ n . d i . v i . d u . a l . ˈɪ s . m ə
Indo	ˈɪ n d o
indoktrinasi	ɪ n . d ɔ k . t r i . ˈn a . s i
Indonesia	i n . ˈd o . n ɛ . s ɪ . j a
Indra	i n . d r a
indra	i n . d r a
indraja	ɪ n ˈd r a d͡ʒ a
industri	ɪ n . ˈd ʊ s . t r i
industrialisasi	ɪ n . d ʊ s . t r i . a . l i . ˈs a . s i
infeksius	ɪ n . f ɛ k . ˈs i . ʊ s
inferensi	ɪ n . f e . ˈr ɛ n . s i
inflasi	ɪ n . ˈf l a . s i
influen	ɪ n ˈf l u ɛ n
informasi	i n f ɔ r m a s i
informatif	ɪ n f ɔ r ˈm a t ɪ f
ingin	i . ŋ i n
inhibitor	ɪ n . h i . ˈb i . t ɔ r
ini	ˈi n i
Injil	ˈɪ n . d͡ʒ ɪ l
insaf	i n . s a f
insektisida	ɪ n . s ɛ k . t i . ˈs i . d a
inset	i n s ɛ t
insidental	ɪ n . s i . ˈd ɛ n . t a l
insisi	ɪ n . ˈs i . s i
inspirasi	ɪ n s p i ˈr a s i
instruksi	ɪ n . ˈs t r ʊ k . s i
instruksional	ɪ n . s t r ʊ k . s i . ˈo . n a l
instruktur	ɪ n . ˈs t r ʊ k . t ʊ r
instrumen	ɪ n . ˈs t r u . m ɛ n
instrumental	ɪ n . s t r u . ˈm ɛ n . t a l
instrumentasi	ɪ n . s t r u . m ɛ n . ˈt a . s i
intensi	i n t ɛ n s i
interferensi	ɪ n t ə r f ə ˈr ɛ n s i
internasional	i n t ə r n a s i o n a l
internuntius	i n t ə r n u n t i u s
intip	ˈɪ n t ɪ p̚
intipan	ɪ n ˈt ɪ p̚ a n
intoleransi	ɪ n t o l e ˈr a n s i
intonasi	ɪ n t o ˈn a s i
introspeksi	ɪ n t r o ˈs p ɛ k̚ s i
inventaris	ɪ n . v ɛ n . ˈt a . r ɪ s
inventarisasi	ɪ n . v ɛ n . t a . r i . ˈs a . s i
inversi	ɪ n . ˈv ɛ r . s i
investor	ɪ n . ˈv ɛ s . t ɔ r
iotasisme	i o t a ˈs ɪ s m ə
IP	ˈi . p e
IPA	i . ˈp a
IPA	i . ˈp e . a
ipar	ˈi p a r
IPM	i ˈp ɛ ɛ m
IPS	i . ˈp e . ɛ s
irama	i r a m a
Irlandia	ɪ r ˈl a n d i a̯
Isa	i s a
isama	i s a m a
isap	i s a p
Islandia	ɪ s ˈl a n d i a̯
isomer	i . ˈs o . m ɛ r
istibra	ɪ s ˈt ɪ p r a ʔ
istigfar	ɪ s ˈt ɪ ʔ f a r
istimewa	ɪ s t i ˈm ɛ w a
istri	i s t r i
isu	ˈɪ s u
isyarat	i . ˈʃ a . r a t
Italia	ɪ ˈt a l i a̯
itas	i t a s
itu	ˈi t u
izin	ˈɪ z ɪ n
j	d͡ʒ e
j	d͡ʒ
J	d͡ʒ e
J	d͡ʒ
Jabar	ˈd͡ʒ a b a r
jadi	d ʒ a . d i
jadul	ˈd͡ʒ a d ʊ l
jadwal	d͡ʒ a t̚ w a l
jadwal	d͡ʒ a d w a l
jaga	d͡ʒ a . ɡ a
jagal	ˈd͡ʒ a . ɡ a l
jagat	j a . ɡ a t
jagung	ˈd͡ʒ a ɡ ʊ ŋ
jajahan	d͡ʒ a ˈd͡ʒ a h a n
Jakarta	d͡ʒ a ˈk a r t a
jala	d͡ʒ a l a
jalan	d ʒ a . l a n
jalu	d͡ʒ a . l u
jamas	ˈd͡ʒ a m a s
jamber	d͡ʒ a m . b ə r
jamu	ˈd͡ʒ a m u
jamur	ˈd͡ʒ a . m ʊ r
janapada	d͡ʒ a . n a . p a . d a
jang	ˈj a ŋ
jangan	d͡ʒ a ŋ a n
jangankan	d͡ʒ a . ŋ a n . k a n
jangka	ˈd͡ʒ a ŋ k a
Januari	d͡ʒ a . n u . ˈa . r i
japri	d͡ʒ a . p r i
jari	ˈd͡ʒ ä . r i
jarum	ˈd͡ʒ a r u m
jasad	ˈd͡ʒ a s a t̚
jasmani	d͡ʒ a s ˈm a n i
jasuke	d͡ʒ a ˈs u k e
jataka	d͡ʒ a ˈt a k a
Jateng	d͡ʒ a ˈt ə ŋ
jati	d͡ʒ a . t i
Jatim	ˈd͡ʒ a t i m
jauhar	ˈd͡ʒ a u̯ h a r
Jawa	d͡ʒ a . w a
jawab	d͡ʒ a . w a p̚
jawi	ˈd͡ʒ a . w i
jazirah	d͡ʒ a ˈz i r a h
jelajah	d͡ʒ ə ˈl a d͡ʒ a h
jelas	d͡ʒ ə ˈl a s
jelata	d͡ʒ ə . l a . t a
jelita	d͡ʒ ə l i t a
jelma	d͡ʒ ə l m a
jelus	d͡ʒ ə ˈl ʊ s
jenasah	d͡ʒ ə ˈn a s a h
jenawi	d͡ʒ ə ˈn a w i
jenazah	d͡ʒ ə ˈn a z a h
jenazah	d͡ʒ ə ˈn a s a h
jeneng	ˈd͡ʒ ɛ . n ɛ ŋ
jeniper	d͡ʒ ə ˈn i p ə r
jentera	d͡ʒ ə n t ə r a
Jepang	d͡ʒ ə ˈp a ŋ
Jepun	d͡ʒ ə p ʊ n
jerami	d͡ʒ ə ˈr a m i
Jerman	ˈd͡ʒ ɛ r m a n
jernih	d͡ʒ ə r ˈn i h
jero	d͡ʒ ə . ˈr o
jidat	ˈd͡ʒ i d a t̚
jijik	d͡ʒ i . d͡ʒ ɪ ʔ
jika	ˈd͡ʒ i k a
jilat	ˈd͡ʒ i l a t
jitu	ˈd͡ʒ i t u
jiwa	d͡ʒ i . w a
Jokowi	d͡ʒ o ˈk o w i
joli	ˈd͡ʒ o l i
JPU	d͡ʒ e ˈp e u
juag	ˈd͡ʒ u a k̚
judo	d͡ʒ u . d o
judogi	d͡ʒ u . d o . ɡ i
judoka	d͡ʒ u . d o . k a
jujitsu	d ʒ u . d ʒ ɪ t . s u
jujutan	d͡ʒ u ˈd͡ʒ ʊ t̚ a n
jujutsu	d ʒ u . d ʒ ʊ t . s u
julang	ˈd͡ʒ u l a ŋ
Juli	ˈd͡ʒ u . l i
Jumat	d͡ʒ ʊ m . ʔ a t
jumbrek	ˈd͡ʒ ʊ m b r ə k̚
jumlah	ˈd͡ʒ ʊ m l a h
Juni	ˈd͡ʒ u . n i
junta	ˈd͡ʒ ʊ n . t a
jurang	ˈd͡ʒ u . r a ŋ
jurnalis	d͡ʒ ʊ r ˈn a l ɪ s
jurnalisme	d͡ʒ ʊ r . n a . ˈl ɪ s . m ə
juta	d͡ʒ u t a
juz	ˈd͡ʒ ʊ z
k	k a
k	k
K	k a
K	k
K/L	ˈk a ɛ l
kaba	ˈk a b a
kabar	ˈk a . b a r
kabinet	k a . ˈb i . n ɛ t
kabisat	k a . ˈb i . s a t̚
kabuki	k a ˈb u k i
kabupaten	k a . b u . p a . t e n
kabur	k a . b ʊ r
kabus	k a b ʊ s
kabut	ˈk a b ʊ t̚
kaca	k a t͡ʃ a
kacamata	k a . t͡ʃ a . m a . t a
kacung	ˈk a t͡ʃ ʊ ŋ
kadaster	k a d a s t ə r
kadaver	k a . d a . v ə r
kadi	ˈk a . d i
kadrun	k a ˈd r ʊ n
kaf	k a f
kaf	k a f
kafilah	k a ˈf i l a h
kaftan	ˈk a f t a n
kahar	ˈk a h a r
kahim	ˈk a h i m
kahrab	ˈk a h r a p̚
kailan	k a . i . l a n
kais	ˈk a . ɪ s
kaisar	k a i s a r
kait	ˈk a ɪ t̚
kajang	ˈk a d͡ʒ a ŋ
kaji	k a d͡ʒ i
kajian	k a . ˈd͡ʒ i . a n
kajur	ˈk a d͡ʒ u r
kakak	k a . k a ʔ
kaki	ˈk ä . k i
kakus	k a k ʊ s
kala	ˈk a l a
kali	k a . l i
kaligrafi	k a . l i . ˈɡ r a . f i
kaliks	ˈk a l ɪ k s
kalimah	k a . ˈl i . m a h
kalis	ˈk a . l ɪ s
kalurahan	k a . l u . ˈr a h . a n
kama	k a . m a
kamber	ˈk a m . b ə r
kami	ˈk ä . m i
kamikaze	k a m i k a z e
Kamis	k a m ɪ s
kampai	ˈk a m . p a i̯
kamu	ˈk a m u
kamuflase	k a m u f l a s ə
kan	k a n
kanca	ˈk ɔ n t͡ʃ ɔ
kandela	k a n . ˈd e . l a
kandelar	k a n . d ə . ˈl a r
kandelir	k a n . d ə . ˈl ɪ r
kandidat	k a n ˈd i . d a t̚
kandil	ˈk a n . d ɪ l
kandung	ˈk a n d ʊ ŋ
kandungan	k a n ˈd ʊ ŋ a n
kanguru	k a ˈŋ u r u
kanit	k a . n i t
kanji	k a n . d͡ʒ i
kanji	k a n . d͡ʒ i
kanji	k a n . d͡ʒ i
kanonis	k a n o n ɪ s
kanstin	ˈk a n . s t ɪ n
kanta	k a n t a
kanti	ˈk a n . t i
kap	ˈk a p̚
kapal	k a . p a l
kapan	k a . p a n
kapanewon	k a . p a . n e . w ɔ n
kapas	ˈk a . p a s
kapitan	k a ˈp i t a n
kaprodi	k a . ˈp r o . d i
kapten	ˈk a p̚ t ɛ n
karak	ˈk a . r a k
karakuri	k a . r a . k u . r i
karam	ˈk a . r a m
karaoke	k a . r a . o . k e
karate	k a . r a . t e
karategi	k a . r a . t e . ɡ i
karateka	k a . r a . t e . k a
kardinal	k a r d i n a l
kardiograf	k a r . d i . ˈo . ɡ r a f
kardiogram	k a r . d i . ˈo . ɡ r a m
kardiolog	k a r . d i . ˈo . l ɔ k
kardiologi	k a r . d i . o . ˈl o . ɡ i
kardiologis	k a r . d i . o . ˈl o . ɡ ɪ s
kardiovaskular	k a r d i o v a s ˈk u l a r
kardiovaskuler	k a r d i o v a s ˈk u l ɛ r
karkas	k a r . k a s
karkun	ˈk a r k ʊ n
karma	k a r m a
karna	k a r . n a
karnivor	k a r ˈn i v ɔ r
karnivora	k a r n i ˈv o r a
karsa	k a r s a
kartel	k a r . t ɛ l
kartika	k a r . t i . k a
kartografer	k a r t o ˈɡ r a f ə r
kartu	ˈk a r t u
kartun	k a r t u n
karunia	k a r u n i a̯
karya	k a r i a
karya	k a r j a
kasar	ˈk a . s a r
kastanya	k a s . ˈt a . ɲ a
kastanye	k a s . ˈt a . ɲ ə
kastel	k a s . t ɛ l
kastil	k a s . t ɪ l
kasuistik	k a s u ˈɪ s t ɪ k̚
katak	ˈk a t a ʔ
katedral	k a t ə d r a l
katoda	k a . t o . d a
katode	k a . t o . d ə
katun	ˈk a t u n
kau	k a u̯
kawal	ˈk a w a l
kawalan	k a ˈw a l a n
kawan	k a . w a n
kawanan	k a ˈw a n a n
kawasan	k a . w a . s a n
kayas	k a ˈj a s
kayau	ˈk a j a w
Kazakstan	k a ˈz a k s t a n
KDRT	k a . d e . ɛ r . t e
keadilan	k ə ˈa d ɪ l a n
keanekaragaman	k ə . a . n ɛ . k a . r a . ɡ a . m a n
keasaman	k ə a ˈs a m a n
kebakaran	k ə ˈb a . k a ˈr a n
kebangsaan	k ə . b a ŋ . s a . a n
kebangsaan	k ə . b a ŋ . s a . ʔ a n
kebebasan	k ə b ɛ ˈb a s a n
keberatan	k ə b ə ˈr a t a n
keberlanjutan	k ə . b ə r . l a n . ˈd͡ʒ ʊ t . a n
kebidanan	k ə . b i . ˈd a n . a n
kebijaksanaan	k ə b i d͡ʒ a k s a ˈn a a n
kebo	k ə ˈb o
kebugaran	k ə . b u . ˈɡ a r . a n
kebuli	k ə ˈb u l i
kebun	k ə . b ʊ n
kebupatian	k ə b u p a ˈt i a n
kebut	k ə ˈb ʊ t̚
kecam	k ə . ˈt͡ʃ a m
kecamatan	k ə . t͡ʃ a . m a . t a n
kecap	k ɛ t͡ʃ a p
kecap	k ə t͡ʃ a p
kecemasan	k ə t͡ʃ ə ˈm a s a n
kecepatan	k ə t͡ʃ ə ˈp a t a n
kecik	ˈk ə . t͡ʃ ɪ ʔ
kecil	k ə ˈt͡ʃ i l
kecil	ˈk e t͡ʃ i l
kecocokan	k ə . t͡ʃ ɔ . ˈt͡ʃ ɔ k . a n
kedaerahan	k ə . d a ɛ . ˈr a h . a n
kedaluwarsa	k ə . d a . l u . ˈw a r . s a
kedatangan	k ə ˈd a t a ŋ a n
kedaton	k ə ˈd a t ɔ n
kedokteran	k ə . d o k . t ə . r a n
kedudukan	k ə . d u . ˈd ʊ k . a n
kedutaan	k ə d u t a a n
keempat	k ə ˈə m p a t
kegagalan	k ə . ɡ a . ˈɡ a l . a n
kegiatan	k ə . ɡ i . ˈa t . a n
kehakiman	k ə . h a . ˈk ɪ m . a n
kehausan	k ə . h a ʊ s . a n
kehidupan	k ə . h i . ˈd ʊ p . a n
kehujanan	k ə ˈh u d͡ʒ a n a n
keibodan	k e i . b o . d a n
keik	k ɛ . i k
kejayaan	k ə . d͡ʒ a . ˈj a . a n
kejuruan	k ə . d͡ʒ u . ˈr u . a n
kek	k ɛ ʔ
kek	k e ʔ
kek	k e k
kekasih	k ə ˈk a s ɪ h
keker	k e . k ə r
keker	k ɛ . k ɛ r
kekosongan	k ə k o ˈs o . ŋ a n
kekuasaan	k ə k u a ˈs a a n
kelab	k ə l a b
kelab	k ə l a p
kelahiran	k ə . l a . ˈh ɪ r . a n
kelajuan	k ə l a ˈd͡ʒ u a n
kelambir	k ə ˈl a m b i r
kelambu	k ə ˈl a m b u
kelapa	k ə ˈl a p a
kelar	k ə . l a r
kelar	k ə . l a r
kelarutan	k ə . l a . r u . t a n
kelas	k ə ˈl a s
kelembapan	k ə . l ə m . ˈb a p . a n
kelengkiak	k ə l ə ŋ ˈk i a k̚
kelenjar	k ə . l ə n . d ʒ a r
kelestarian	k ə . l ə s . t a . ˈr i . a n
kelinci	k ə ˈl ɪ n . t͡ʃ i
kelok	ˈk e . l ɔ ʔ
kelola	k ə . ˈl o . l a
keluar	k ə . l u . a r
keluaran	k ə l u ˈa r a n
kelurahan	k ə . l u . ˈr a h . a n
kemacetan	k ə m a t͡ʃ ə t ˈa n
kemanusiaan	k ə m a n u ˈs i a̯ a n
kembang	k ə m ˈb a ŋ
kemenakan	k ə m ə ˈn a k a n
kemiringan	k ə . m i . ˈr ɪ ŋ . a n
Kemlu	k ə m ˈl u
kempetai	k e m ˈp e . t a i̯
kempis	k ə m ˈp ɪ s
kemudahan	k ə m u ˈd a h a n
kemurungan	k ə . m u . ˈr ʊ ŋ . a n
ken	k ɛ n
ken	k ɛ n
kenan	k ə . ˈn a n
kenapa	k ə . ˈn ä . p ä
kencan	k ə n ˈt͡ʃ a n
kencana	k ə n . t͡ʃ a . n a
kenceng	k ə n . t͡ʃ ə ŋ
kendala	k ə n ˈd a l a
kendaraan	k ə n ˈd a . r a ʔ a n
kendi	k ə n d i
kendo	k ɛ n . d o
kenek	k ə ˈn ɛ k
kening	ˈk ə . n ɪ ŋ
kenken	ˈk e n k e n
kenyataan	k ə . ɲ a . ˈt a . a n
kepada	k ə ˈp a d a
keparat	k ə . p a . r a t
kepatuhan	k ə . p a . ˈt ʊ h . a n
kepolisian	k ə p o l i ˈs i a n
keponakan	k ə p o ˈn a k a n
keprabuan	k ə p r a ˈb u a n
keputusasaan	k ə p u t u s a ˈs a a n
kera	k ə ˈr a
kerajinan	k ə r a ˈd͡ʒ ɪ n a n
kerak	k ə ˈr a k
keramat	k ə ˈr a m a t̚
keramik	k ə ˈr a m ɪ k̚
keranda	k ə r a n d a
keras	k ə ˈr a s
keratabasa	k ə r a t a ˈb a s a
keraton	k ə ˈr a t ɔ n
kerbau	k ə r b a u̯
kerepek	k ə ˈr ɛ p ə k̚
kereta	k ə ˈr e t a
kering	k ə ˈr ɪ ŋ
keripik	k ə ˈr i p ɪ k̚
kernet	k ə r ˈn ɛ t̚
kerosin	k e ˈr o s ɪ n
kers	ˈk ɛ r s
kersen	ˈk ɛ r s ə n
kertas	k ə r ˈt a s
keruh	k ə ˈr ʊ h
kesalahan	k ə s a ˈl a h a n
kesegarisan	k ə . s ə . ɡ a . ˈr ɪ s . a n
kesejahteraan	k ə s ə d͡ʒ a h t ə ˈr a a n
kesengajaan	k ə s ə ŋ a ˈd͡ʒ a a n
kesenjangan	k ə . s ə n . d͡ʒ a ŋ . a n
keseruan	k ə s ə ˈr u a n
kesesakan	k ə . s ə . ˈs a k . a n
kesukaran	k ə . s u . ˈk a r . a n
ketahanan	k ə t a ˈh a n a n
ketan	k ə ˈt a n
ketat	k ə ˈt a t
ketatanegaraan	k ə . t a . t a . n ə . ɡ a . ˈr a . a n
ketentuan	k ə t ə n ˈt u a n
keterangan	k ə . t ə . r a . ŋ a n
ketersediaan	k ə . t ə r . s ə . d i . ˈa . a n
ketimbang	k ə . ˈt ɪ m . b a ŋ
ketimpangan	k ə t ɪ m ˈp a ŋ a n
ketinggalan	k ə ˈt i ŋ . ɡ a . l a n
ketombe	k ə ˈt ɔ m b e
ketuhanan	k ə t u ˈh a n a n
ketumbar	k ə ˈt ʊ m b a r
keturunan	k ə . t u . r u . n a n
keuskupan	k ə . u s . k u p . a n
kewajiban	k ə w a ˈd͡ʒ i b a n
kewajiban	k ə w a ˈd͡ʒ i p a n
kewarganegaraan	k ə w a r ɡ a n ə ɡ a ˈr a a n
kewartawanan	k ə . w a r . t a . ˈw a n . a n
Khairunnisa	ˈx a i r u n i s a
khalayak	x a ˈl a j a ʔ
khalifah	x a . l i . f a ʔ
khatam	ˈx a t a m
khatam	h a t a m
khatam	k a t a m
khawatir	x a ˈw a t ɪ r
khawatir	k a ˈw a t ɪ r
khawatir	h a ˈw a t ɪ r
khidmat	ˈx i d m a t
khilafah	x i . l a . f a h
khizanatulkitab	x i z a n a t ʊ l ˈk i t a p̚
khoja	ˈx o d͡ʒ a
KHS	k a ˈh a ɛ s
kiai	ˈk i a i̯
kicauan	k i ˈt͡ʃ a u̯ a n
kidal	k i d a l
kikuk	ˈk i k ʊ k̚
kilang	k i l a ŋ
kilap	ˈk i l a p̚
kimono	k i . m o . n o
kimpal	ˈk i m p a l
kimus	ˈk i m ʊ s
kinase	k i . ˈn a . s ə
kini	ˈk i n i
kinoa	ˈk i n o a̯
kira	k i . r a
kirana	k i r a n a
kirik	ˈk i . r ɪ ʔ
kisi	ˈk i s i
kita	ˈk i . t ä
kitab	ˈk i . t a p̚
kitas	k i . t a s
KK	k a . k a
KKN	k a ˈk a ɛ n
klasemen	k l a s ə ˈm ɛ n
klasifikasi	k l a s i f i ˈk a s i
klasikal	k l a ˈs ɪ k . a l
klaver	ˈk l a . v ə r
klem	ˈk l ɛ m
klep	ˈk l ɛ p̚
klinikal	k l i . n i . k a l
klinis	k l i . n i s
klitik	k l i . t i k
klop	ˈk l ɔ p̚
klub	ˈk l u p
kobak	ˈk o b a ʔ
kofte	ˈk ɔ f t e
kohesi	k o ˈh e s i
koja	ˈk o d͡ʒ a
koki	k o . k i
kokoh	ˈk o k ɔ h
kolaborator	k ɔ l a b ɔ ˈr a t ɔ r
kolam	ˈk o . l a m
kolega	k o ˈl e ɡ a
kolektivisme	k o l ɛ k t i ˈv ɪ s m ə
kolektivitas	k o l ɛ k t i ˈv i t a s
kolik	k o . l ɪ k
kolon	ˈk o l ɔ n
kolusi	k o ˈl u s i
komandan	k o . m a n . d a n
kombinasi	k ɔ m b i ˈn a s i
komet	ˈk o . m ɛ t̚
komisi	k o ˈm i . s i
komite	k o ˈm i . t e
kompet	ˈk ɔ m p ɛ t̚
kompetisi	k ɔ m p ə ˈt i s i
kompi	ˈk ɔ m p i
kompleks	ˈk ɔ m p l ɛ k s
komplementer	k ɔ m . p l ə . ˈm ɛ n . t ɛ r
komplot	k o m p l o t
kompon	ˈk ɔ m . p ɔ n
komposit	k ɔ m p o ˈs ɪ t̚
kompresor	k ɔ m ˈp r ɛ s ɔ r
komunikasi	k o m u n i ˈk a s i
komunis	k o ˈm u n ɪ s
kondensor	k ɔ n ˈd ɛ n s ɔ r
konduksi	k ɔ n ˈd ʊ k s i
konduktivitas	k ɔ n . d ʊ k . t i . ˈv i . t a s
koneksi	k o n ɛ k s i
konfeti	k o n . f e . t i
konfirmasi	k ɔ n f ɪ r ˈm a s i
kongruen	k ɔ n . ˈɡ r u . ɛ n
konjungtiva	k ɔ n d͡ʒ ʊ ŋ ˈt i v a
konkordansi	k ɔ n k ɔ r ˈd a n s i
konosemen	k o . n o . ˈs ə . m ɛ n
konpers	ˈk ɔ n p ɛ r s
konsiderans	k ɔ n s i d ə ˈr a n s
konsiderasi	k ɔ n s i d ə ˈr a s i
konstruk	ˈk ɔ n . s t r ʊ k̚
konsul	ˈk ɔ n s ʊ l
konsuler	k ɔ n ˈs u l ɛ r
konsultatif	k ɔ n . s ʊ l . ˈt a . t ɪ f
konsumerisme	k ɔ n s u m ɛ r ˈɪ s m ə
kontes	ˈk ɔ n t ɛ s
kontestan	k ɔ n ˈt ɛ s t a n
kontestasi	k ɔ n t ɛ s ˈt a s i
kontingensi	k ɔ n . t i . ˈŋ ɛ n . s i
kontinuitas	k ɔ n t i n u ˈi t a s
kontributor	k ɔ n . t r i . ˈb u . t ɔ r
konus	ˈk o n ʊ s
koordinasi	k o ʔ ɔ r d i ˈn a s i
kop	k o p
koper	ˈk o p ə r
koperasi	k o . p ə . r a . s i
kopi	k o . p i
kopitiam	k o p i t i a m
kopra	ˈk o . p r a
kopral	ˈk ɔ p . r a l
kor	ˈk ɔ r
koroner	k o ˈr o . n ɛ r
korporal	k ɔ r . ˈp o . r a l
korps	ˈk ɔ r p s
kosakata	k o . s a . ˈk a . t a
kosmonaut	k ɔ s m o n a u̯ t̚
kota	k o t a
kotor	k o t o r
KPK	k a ˈp e k a
KPR	k a . ˈp e . ɛ r
krans	ˈk r a n s
kredo	ˈk r e . d o
krida	k r i d a
kring	k r ɪ ŋ
kriptogam	k r ɪ p ˈt o ɡ a m
kriptogamik	k r ɪ p t o ˈɡ a m ɪ k
Kristen	ˈk r ɪ s . t ə n
kruk	k r ʊ k
krusial	k r u . s i . a l
KTP	k a t ɛ ˈp ɛ
KTSP	k a t e ˈɛ s p e
KTT	k a . ˈt e . t e
ku	k u
kuadran	ˈk u a̯ d r a n
kuantum	k u ˈa n t ʊ m
kuap	ˈk u a p̚
kuartal	k u a r t a l
kuas	ˈk u a s
kuat	ˈk u a t̚
kubak	ˈk u b a ʔ
kubu	ˈk u . b u
kucing	ˈk u t͡ʃ ɪ ŋ
kudeta	k u ˈd ɛ t a
kuil	k u ɪ l
kuilu	k u ˈi . l u
kuintal	ˈk w i n t a l
kuitansi	k u i̯ ˈt a n s i
kuku	ˈk u k u
kukuh	ˈk u k ʊ h
kukus	ˈk u k ʊ s
kulah	ˈk u l a h
kuliah	k u ˈl i a h
kultivar	k ʊ l . ˈt i . v a r
kultivasi	k ʊ l t i ˈv a s i
kumico	k u . m i . t͡ʃ o
kumpul	ˈk ʊ m p ʊ l
kumpulan	k ʊ m ˈp ʊ l a n
kumulatif	k u m u ˈl a t ɪ f
kuna	ˈk u n a
kunjung	ˈk ʊ n . d͡ʒ ʊ ŋ
kuno	ˈk u n o
kuntit	ˈk ʊ n t ɪ t̚
kuping	k u p ɪ ŋ
kurang	k u . r a ŋ
kurawa	k u ˈr a w a
kurikulum	k u r i ˈk u l ʊ m
kurung	ˈk u . r ʊ ŋ
kusta	k ʊ s t a
kustar	ˈk ʊ s t a r
kusuma	k u s u m a
kutang	k u . t a ŋ
kutikula	k u t i ˈk u l a
kuwu	ˈk u . w u
kuy	ˈk u j
kwasiorkor	k w a s i ˈɔ r k ɔ r
KY	ˈk a j e
kĕlir	k ə l ɪ r
l	ɛ l
l	l
L	ɛ l
L	l
labah	l a b a h
lada	ˈl a d a
lahad	ˈl a h a t̚
laher	l a . h ə r
lahir	ˈl a . h ɪ r
lajak	ˈl a d͡ʒ a k̚
laju	ˈl a d͡ʒ u
lajur	ˈl a d͡ʒ u r
laki	ˈl a k i
laknat	ˈl a k n a t̚
lakon	ˈl a k ɔ n
laksa	l a k s a
laksamana	l a k s a m a n a
laksana	l a k s a n a
laksmana	l a k s . m a . n a
laku	ˈl a k u
lakuan	l a ˈk u a n
lalai	ˈl a l a i̯
lalat	ˈl a . l a t̚
laler	ˈl a . l ə r
lali	ˈl a l i
lama	l a . m a
laman	l a . m a n
lambung	ˈl a m . b ʊ ŋ
lampak	ˈl a m p a k̚
lanca	l a n . t͡ʃ a
lancia	l a n . t͡ʃ i a̯
landasan	l a n . d a . s a n
landasan	l a n . d a s . a n
lang	ˈl a ŋ
langau	l a ŋ a u̯
langca	l a ŋ . t͡ʃ a
langcia	l a ŋ . t͡ʃ i a̯
langgeng	ˈl a ŋ . ɡ ə ŋ
langit	ˈl ɑː ŋ ɪ t̚
langka	ˈl a ŋ k a
lanjar	ˈl a n d͡ʒ a r
lansia	l a n ˈs i a
lantai	l a n t a i̯
lantama	l a n ˈt a m a
lantamal	l a n ˈt a m a l
lantamil	l a n ˈt a m ɪ l
lantas	ˈl a n t a s
laos	ˈl a . ɔ s
lapang	l a p a ŋ
lapangan	l a ˈp a ŋ a n
lapar	ˈl a p a r
lapis	ˈl a . p ɪ s
lapo	ˈl a p o
lapuk	ˈl a p u k
laras	ˈl a . r a s
lasik	l a . s i k
laskar	l a s ˈk a r
lateks	ˈl a . t ɛ k s
lateral	l a . t ə . ˈr a l
latih	ˈl a t ɪ h
latpur	ˈl a t̚ p ʊ r
lauh	ˈl a ʊ h
lauk	ˈl a . ʊ ʔ
lava	ˈl a . v a
lawan	l a . w a n
layan	ˈl a j a n
layanan	l a ˈj a n a n
layang	ˈl a . j a ŋ
layu	ˈl a . j u
lazuardi	l a z u a r d i
lebar	ˈl e b a r
legalisasi	l ɛ ɡ a l i ˈs a s i
leger	l ɛ ɡ ə r
leher	ˈl e̞ . h e̞ r
lekas	l ə ˈk a s
lekong	l e . k o ŋ
lektor	l ɛ k . t o r
lelang	ˈl ɛ l a ŋ
lelangit	l ə . ˈl ä . ŋ ɪ t̪̚
lemah	l ə m a h
lembah	l ə m ˈb a h
lembar	l ə m b a r
lembing	l ə m . ˈb ɪ ŋ
lemper	ˈl ə m p ə r
lempir	l ə m ˈp ɪ r
lempira	l e m ˈp i r a
lencang	l ə n ˈt͡ʃ a ŋ
lenceng	ˈl ɛ n t͡ʃ ɛ ŋ
lenceng	l ə n ˈt͡ʃ ə ŋ
lenga	l ə . ˈŋ a
lengah	ˈl ɛ ŋ a h
lengan	ˈl ə . ŋ ä n
lengket	ˈl ɛ ŋ k ɛ t̚
lengkuas	l ə ŋ . ˈk u . a s
lengkung	l ə ŋ . ˈk ʊ ŋ
lenjer	l ə n ˈd͡ʒ ə r
lensa	l ɛ n s a
lepasan	l ə ˈp a s a n
lepau	l ə ˈp a u̯
lepra	l ɛ p r a
lereng	ˈl ɛ . r ɛ ŋ
lestari	l ə s . ˈt a . r i
letak	l ə ˈt a ʔ
letak	ˈl ɛ t a ʔ
letjen	l ə t ˈd͡ʒ ə n
letjend	l ə t ˈd͡ʒ ə n d
lev	ˈl e p̚
LGBT	ɛ l ɡ e ˈb e t e
liabilitas	l i . a . b i . ˈl i . t a s
liana	ˈl i a̯ n a
lidah	ˈl i . d ä h
ligamen	l i ˈɡ a m ɛ n
ligan	ˈl i . ɡ a n
lihat	l i h a t̚
lima	ˈl i . m ä
limas	ˈl i m a s
limit	ˈl i m ɪ t̚
linear	l i ˈn ɛ a r
linier	l i ˈn i ɛ r
lintasan	l ɪ n . ˈt a s . a n
lipat	ˈl i . p a t̚
lipur	l i . p ʊ r
lisan	l i . s a n
litbangjirap	l ɪ t . b a ŋ . ˈd͡ʒ i . r a p
literasi	l i t ə ˈr a s i
litigasi	l i . t i . ˈɡ a . s i
liturgis	l i . ˈt ʊ r . ɡ ɪ s
liyan	ˈl i j a n
lobak	l o . b a k
lobang	ˈl o b a ŋ
loh	ˈl ɔ h
loji	l o d͡ʒ i
lokalisasi	l o k a l i s a s i
lokalisir	l o k a l i s ɪ r
lokapasar	l o k a ˈp a s a r
loket	a b o n ə m ɛ n
lomba	ˈl ɔ m b a
lompat	ˈl ɔ m p a t̚
loper	l o . p ə r
losin	ˈl o . s i n
losion	l o ˈs i ɔ n
losmen	l o s . m ɛ n
lowong	ˈl ɔ w ɔ ŋ
LPMP	ɛ l p e ˈɛ m p e
luak	ˈl u a k̚
luang	ˈl u a ŋ
luap	ˈl u a p̚
luar	l u a r
luas	l u a s
lubang	ˈl u b a ŋ
lubuk	ˈl u b ʊ k̚
lucu	l u . t͡ʃ u
lues	l u . e s
luka	ˈl u k a
lulusan	l u ˈl ʊ s a n
lumbung	ˈl ʊ m b ʊ ŋ
lumpia	ˈl ʊ m p i a̯
lumut	ˈl u m ʊ t̚
luncur	l ʊ n t͡ʃ ʊ r
lupa	l u . p a
lurah	ˈl u . r a h
luring	l u r ɪ ŋ
lurus	l u . r u s
lusin	ˈl u s i n
luwes	ˈl u w ə s
m	ɛ m
m	m
M	ɛ m
M	m
mabuk	m a b u k
madam	ˈm a . d a m
madrasah	m a d ˈr a s a h
maestro	m a . ˈɛ s . t r o
mag	ˈm ɑ h
mag	ˈm ɑ x
magang	ˈm a . ɡ a ŋ
mager	ˈm a ɡ ə r
magfirah	m a ʔ ˈf i r a h
magis	ˈm a . ɡ ɪ s
magnet	ˈm a k . n ɛ t
magnitudo	m a k n i ˈt u d o
maha	ˈm a h a
mahakuasa	m a h a k u a s a
mahkota	m a h ˈk o t a
mahram	ˈm a h r a m
main	m a i n
maja	ˈm a d͡ʒ a
majelis	m a ˈd͡ʒ ə l ɪ s
majenun	m a ˈd͡ʒ ə n ʊ n
maju	ˈm a . d͡ʒ u
majusi	m a ˈd͡ʒ u s i
maka	ˈm a k a
makalah	m a . ˈk a . l a h
makan	m a . k a n
makanan	m a k a . n a n
makar	ˈm a k a r
makaroni	m a . k a . ˈr o . n i
makasih	m a . k a . s ɪ h
makhluk	ˈm a x l ʊ k̚
maklumat	m a ʔ ˈl u m a t̚
makmum	ˈm a ʔ m ʊ m
makmur	ˈm a ʔ m ʊ r
makna	ˈm a ʔ n a
makrokosmos	m a k . r o . ˈk ɔ s . m ɔ s
maktub	ˈm a k t u b
malaka	m a . ˈl a . k a
malam	ˈm a l a m
malas	ˈm a l a s
malat	ˈm a l a t̚
malem	m a . l ə m
malik	ˈm a . l ɪ ʔ
maling	ˈm a . l ɪ ŋ
Malingsia	m ä l ɪ ŋ . s i a
Malingsial	m ä l ɪ ŋ . s i a l
maljum	ˈm a l d͡ʒ u m
mama	ˈm a m a
mampu	m a m p u
mana	m a . n a
manajer	m a . ˈn a . d͡ʒ ə r
mancanegara	m a n . t͡ʃ a . n ə ˈɡ a . r a
mandiri	m a n . d i . r i
mandraguna	m a n . d r a . ˈɡ u . n a
mandu	ˈm ʌ n . d ʊ
manga	ˈm a n ɡ a
manga	ˈm a ŋ a
mangaka	m a n . ɡ a . k a
mangkat	ˈm a ŋ k a t̚
mangkuk	ˈm a ŋ k ʊ k̚
manipulasi	m a n i p u ˈl a s i
manira	m a . ˈn i . r a
manset	ˈm a n s ɛ t
mantan	ˈm a n t a n
mantap	ˈm a n t a p̚
mantel	ˈm a n . t ə l
manti	ˈm a n t i
mantra	m a n t r a
mantri	m a n t ə r i
mantul	ˈm a n t ʊ l
manufaktur	m a . n u . ˈf a k . t ʊ r
manuver	m a . ˈn u . v ə r
map	ˈm a p̚
mapel	m a . p ə l
Maret	ˈm a r ə t
margarin	m a r ˈɡ a r ɪ n
margasatwa	m a r . ɡ a . ˈs a t . w a
margin	ˈm a r . ɡ ɪ n
marhaban	m a r ˈh a b a n
marhabanan	m a r h a ˈb a n a n
mari	m a . r i
Maria	m a . ˈr i . a
markas	ˈm a r . k a s
marmer	ˈm a r m ə r
Maroko	m a . ˈr o . k o
Maryam	ˈm a r . j a m
masak	ˈm a s a k̚
masak	ˈm a s a ʔ
masakan	m a ˈs a k̚ a n
masam	ˈm a s a m
masih	m a . s i h
masjid	ˈm a s d͡ʒ ɪ t̚
massal	ˈm a s s a l
mastautin	m a s ˈt a u̯ t ɪ n
masturbasi	m a s t ʊ r ˈb a s i
masyarakat	m a ʃ a ˈr a k a t̚
matahari	m a t a ˈh a r i
materai	m a . t ə . r a i
matkul	m a t . k ʊ l
matpel	m a t . p ə l
mawas	ˈm a w a s
maya	m a . j a
mayat	ˈm a j a t̚
mayit	ˈm a j i t̚
mazbah	ˈm a z b a h
Mbojo	ˈm b o j o
mecin	m ɛ . t͡ʃ i n
medan	ˈm ɛ d a n
megafon	m ɛ ˈɡ a f ɔ n
Mei	ˈm e i̯
mekar	m ə . k a r
melansir	m ə . ˈl a n . s ɪ r
melekas	m ə l ə ˈk a s
melekaskan	m ə l ə k a s k a n
meletus	m ə l ə t u s
meloka	m ə . l o . k a
memaafkan	m ə . m a . a f . k a n
memakan	m ə . m a k a n
memantau	m ə ˈm a n t a u̯
memapan	m ə ˈm a p a n
memasak	m ə ˈm a s a k̚
memasang	m ə m a s a ŋ
membaca	m ə m ˈb a t͡ʃ a
membakar	m ə m . b a . k a r
membangun	m ə m ˈb a ŋ u n
membanguni	m ə m b a ˈŋ ʊ n i
membangunkan	m ə m b a ˈŋ ʊ n k a n
membantah	m ə m . b a n . t a h
membata	m ə m ˈb a t a
membawa	m ə m ˈb a w a
membeli	m ə m . b e . l i
membenang	m ə m ˈb ə n a ŋ
memberantakkan	m ə m . b ə . r a n . t a k . k a n
memberhentikan	m ə m b ə r h ə n ˈt i k a n
memberi	m ə m b ə r i
memberikan	m ə m b ə r i k a n
membilah	m ə m ˈb i l a h
membranofon	m ɛ m b r a ˈn o f ɔ n
membuka	m ə m ˈb u k a
membulat	m ə m ˈb u l a t
membulu	m ə m ˈb u l u
membunuh	m ə m b u n ʊ h
membutir	m ə m ˈb u t i r
meme	ˈm ɛ m ɛ
meme	ˈm i m
memencar	m ə ˈm ə n t͡ʃ a r
memerban	m ə . m ə r . b a n
memetieskan	m ə . m ə . t i . ɛ s . k a n
memfermentasikan	m ə m f e r m e n t a ˈs i k a n
memilih	m ə . m i . l i h
memiliki	m ə ˈm i l ɪ k i
memimpin	m ə ˈm ɪ m p ɪ n
memimpinkan	m ə m i m ˈp i n k a n
memindai	m ə . m i n . d a i̯
memodernkan	m ə . m o . d ɛ r n . k a n
memola	m ə ˈm o l a
mempengaruhi	m ə m . p ə . ŋ a . r u h . i
memperaman	m ə m p ə r ˈa m a n
memperburuk	m ə m p ə r ˈb u r ʊ k̚
memperkeruh	m ə m p ə r k ə ˈr ʊ h
memperketat	m ə m p ə r k ə t a t
memperkokoh	m ə m p ə r ˈk o k ɔ h
memproklamasikan	m ə m p r o k l a m a ˈs i k a n
mempunyai	m ə m . ˈp u . ɲ a . i
memukul	m ə . m u . k ʊ l
memunculkan	m ə . m u n . t͡ʃ ʊ l . k a n
memutakhirkan	m ə m u t a x i r k a n
menabelkan	m ə n a b ə l k a n
menak	ˈm e . n a k
menambah	m ə n a m b a h
menampilkan	m ə n a m p i l k a n
menang	m ə n a ŋ
menangkap	m ə ˈn a ŋ k a p̚
menara	m ə ˈn a r a
menatapi	m ə . n a . t a p . i
menayangkan	m ə n a j a ŋ k a n
mencacat	m ə n . t͡ʃ a . t͡ʃ a t
mencari	m ə n ˈt͡ʃ a r i
mencatat	m ə n ˈt͡ʃ a t a t̚
mencekoki	m ə ɲ . t͡ʃ ə . k o . k i
mencekoki	m ə ɲ . t͡ʃ ə . k o ʔ . i
mencekokkan	m ə n . t͡ʃ ə . k o ʔ . k a n
mencela	m ə ŋ t͡ʃ ə l a
mencium	m ə ɲ t͡ʃ i u m
mendam	m ə n . ˈd a m
mendarahi	m ə n . d a . ˈr a h . i
mendasar	m ə n ˈd a s a r
mendaun	m ə n ˈd a u n
mendengar	m ə n . d ə . ŋ a r
mendiamkan	m ə n d i a m k a n
mendoa	m ə n d o a
mendobrak	m ə n d o b r a k
mendung	m ə n d u ŋ
menel	ˈm e n e l
menelaah	m ə . n ə . l a . ʔ a h
menemukan	m ə n ə ˈm u k a n
mengabadi	m ə ŋ . a . b a . d i
mengaben	m ə . ŋ a . b ɛ n
mengabsen	m ə ŋ . a p . s e n
mengalir	m ə ŋ . ˈa . l ɪ r
mengamankan	m ə ŋ ˈa m a n k a n
menganggap	m ə ŋ ˈa ŋ ɡ a p̚
menganiaya	m ə ŋ a n i a j a
menganiayai	m ə ŋ a n i a j a i
mengapa	m ə . ŋ a . p a
mengatakan	m ə ŋ a ˈt a k a n
mengecam	m ə . ŋ ə . ˈt͡ʃ a m
mengemasi	m ə ɲ ə m a s i
mengemban	m ə ŋ ə m ˈb a n
mengenai	m ə ŋ ə n a i
mengencingi	m ə . ŋ e n . c i ŋ . i
mengendalikan	m ə . ŋ ə n . d a . l i . k a n
mengerti	m ə . ˈŋ ə r . t i
mengetatkan	m ə ŋ ə t a t̚ k a n
menggali	m ə ŋ . ɡ a . l i
menggarisbawahi	m ə ŋ . ɡ a . r i s . b a . w a h . i
menggarisi	m ə ŋ . ɡ a . r i s . i
menggempita	m ə ŋ . ɡ ə m . p i . t a
menghadap	m ə ŋ . ˈh a . d a p
menghadiri	m ə ŋ . h a . d i r . i
menghadirkan	m ə ŋ . h a . d i r . k a n
menghasilkan	m ə ŋ h a s i l k a n
menghukum	m ə ŋ . h u . k ʊ m
mengiler	m ə ŋ . i . l ə r
mengimbuh	m ə ŋ . i m . b u h
mengingat	m ə ŋ ˈɪ ŋ a t̚
mengirik	m ə ŋ . ˈi . r ɪ ʔ
mengirik	m ə . ˈŋ i . r ɪ ʔ
mengkar	m ə ŋ . ˈk a r
mengoplos	m ə ŋ . o p . l o s
mengubah	m ə ˈŋ u b a h
mengubah	m ə ŋ ˈʔ u b a h
mengumpamakan	m ə ŋ u m p a m a k a n
mengurutkan	m ə ŋ u ˈr u t k a n
menikah	m ə n i k a h
menilai	m ə n i l a i
meninggal	m ə ˈn ɪ ŋ ɡ a l
meninggali	m ə ˈn i ŋ . ɡ a ˈl i
menit	m ə ˈn ɪ t
menjadi	m ə n ˈd͡ʒ a d i
menjaga	m ə n ˈd͡ʒ a ɡ a
menjari	m ə n ˈd͡ʒ a r i
menjaring	m ə n ˈd͡ʒ a r i ŋ
menjarum	m ə n ˈd͡ʒ a r u m
menjelaskan	m ə n d͡ʒ ə ˈl a s k a n
menjijikkan	m ə n . d͡ʒ i . d͡ʒ ɪ ʔ . k a n
menopause	m e n o p a ˈu s ə
menorah	m e ˈn o r a h
mentol	ˈm ɛ n . t ɔ l
menuntut	m ə . n u n . t ʊ t
menurun	m ə ˈn u r ʊ n
menyanggah	m ə ˈɲ a ŋ ɡ a h
menyatakan	m ə ɲ a ˈt a k a n
menyebar	m ə ɲ ə ˈb a r
menyerahkan	m ə ɲ ə r a h k a n
menyerat	m ə ˈɲ ə r a t
menyiarkan	m ə ɲ i a r k a n
menyimpan	m ə ɲ i m p a n
menyita	m ə . ɲ i . t a
menyunting	m ə ɲ u n t i ŋ
menyusun	m ə . ɲ u . s ʊ n
meong	ˈm e . o ŋ
meragu	m ə ˈr a ɡ u
merah	ˈm ɛ r a h
merah	m ə ˈr a h
merah	m ə ˈr a h
meraih	m ə r a i h
meraja	m ə r a d͡ʒ a
merebus	m ə r ə b ʊ s
meritokrasi	m e . r i . t o . ˈk r a . s i
meritokratis	m e . r i . t o . ˈk r a . t ɪ s
merk	m ɛ r k
Merkurius	m ɛ r . k u . ˈr i . ʊ s
mertua	m ə r ˈt u a̯
merubah	m ə ˈr u b a h
merunut	m ə ˈr u n u t
merupakan	m ə r u p a k a n
merusak	m ə r u s a ʔ
mesjid	m ə s ˈd͡ʒ ɪ t̚
meta	a b o n ə m ɛ n
metabolisme	m ɛ t a b o ˈl ɪ s m ə
metamorfosis	m e t a m ɔ r ˈf o s ɪ s
metana	m ɛ . t a . n a
mewah	ˈm ɛ w a h
micin	m i . t͡ʃ i n
migrasi	m i ˈɡ r a s i
mikrob	m i ˈk r ɔ p
mil	ˈm ɪ l
min	ˈm ɪ n
minaret	m i ˈn a r ɛ t
minder	ˈm ɪ n . d ə r
minta	ˈm i n t a
MIPA	m i . p a
mirip	ˈm i r i p
miskin	ˈm ɪ s . k ɪ n
mitigasi	m i . t i . ˈɡ a . s i
mitos	m i t o s
mizab	ˈm i z a p̚
moci	m o t͡ʃ i
moda	ˈm o . d a
modalitas	m o d a ˈl i t a s
moga	ˈm o ɡ a
moksa	m o k . s a
moktail	m ɔ k̚ ˈt a ɪ l
mol	ˈm ɔ l
molekuler	m o . l ə . ˈk u . l ɛ r
molor	m o l ɔ r
momentum	m o . ˈm ɛ n . t ʊ m
monarki	m o ˈn a r k i
monomer	m o ˈn o m ɛ r
monsun	m u n s o n
montase	m ɔ n . ˈt a . s ə
mosaik	m o ˈs a ɪ k̚
mu	m u
mual	ˈm u a l
muamalah	m u a m a l a h
muda	m u . d a
mudah	m u d a h
mudarat	m u d a r a t
mudigah	m u ˈd i ɡ a h
mudra	m u d . r a
mufasir	m u f a s ɪ r
mufrad	ˈm ʊ f r a t̚
muhrim	ˈm ʊ h r ɪ m
muka	m u k a
mukbang	ˈm ʊ k b ɑ ŋ
mukbang	ˈm uː k b ɑ ŋ
mukjizat	m ʊ ʔ ˈd͡ʒ i z a t̚
mukminat	m ʊ ʔ ˈm i n a t̚
mukminin	m ʊ ʔ ˈm i n ɪ n
muktamad	m ʊ ʔ . ˈt a . m a t
muktamar	m ʊ ʔ ˈt a m a r
mula	m u l a
mulai	m u . l a i̯
mulia	m u ˈl i a
muluk	ˈm u . l ʊ ʔ
mulut	ˈm u . l u t̪̚
mungkir	ˈm u ŋ k i r
munsyi	m u n . ʃ i
mur	m u r
murka	ˈm ʊ r . k a
musang	ˈm u s a ŋ
muson	m u s o n
mustahak	m ʊ s ˈt a h a k̚
mustahik	m ʊ s ˈt a h ɪ k̚
musyawarah	m u ʃ a ˈw a r a h
mutasi	m u . t a . s i
mutlak	ˈm ʊ t l a k
muwakil	m u w a k i l
n	n
n	ɛ n
N	ɛ n
N	n
nabatah	n a b a t a h
nabati	n a b a t i
nabi	ˈn a b i
nada	ˈn a . d a
nafiri	n a ˈf i r i
nagari	n a ˈɡ a r i
nah	n a h
nahas	ˈn a h a s
nahu	ˈn a h u
nakhoda	n a ˈx o d a
nakhoda	n a ˈk o d a
nalam	ˈn a l a m
nalar	ˈn a l a r
nanas	n a n a s
nanti	n a n . t i
narakontak	n a r a ˈk ɔ n t a k̚
narapidana	n a . r a . p i . ˈd a . n a
narasi	n a . ˈr a . s i
naratif	n a . ˈr a . t ɪ f
nasabah	n a ˈs a b a h
nasi	ˈn a s i
nasionalisme	n a . s i . o . n a . l i s . m ə
nasionalisme	n a . s j o . n a . l i s . m ə
nasionalisme	n a s . j o . n a . l i s . m ə
naskah	ˈn a s . k a h
Nasrani	n a s . r a . n i
Natal	n a . t a l
natural	n a . ˈt u . r a l
Naufal	n a u . f a l
nazar	ˈn a z a r
negeri	n ə ɡ ə r i
negoisasi	n ɛ . ɡ o . s i . a . s i
nekrokrasi	n e k r o k r a s i
nenek	n e̞ n e ʔ
nepotisme	n e p ɔ t̚ ˈɪ s m ə
neraka	n ə ˈr a k a
nestapa	n ə s ˈt a p a
netra	n ə t . r a
ngab	ŋ a b
Ngawi	ŋ a ˈw i
ngentot	ŋ ɛ n . t o t
niat	ˈn i a t̚
nila	n i . l a
nira	n i . r a
nirharapan	n i r h a r a p a n
nirkarat	n i r k a r a t
nirmakna	n i r m a k n a
nirmasalah	n i r m a s a l a h
nirwana	n i r . w a . n a
nisbah	ˈn ɪ s b a h
noda	ˈn o d a
nopek	n o p ɛ ʔ
nori	n o . r i
Norwegia	n ɔ r . w e . ɡ i a̯
not	ˈn ɔ t
November	n o . ˈv ɛ m . b ə r
November	n o . ˈp ɛ m . b ə r
NSPK	ɛ n ɛ s ˈp e k a
nuansa	n u ˈa n s a
nutrien	n u ˈt r i ɛ n
nyaman	ˈɲ a m a n
nyambai	ɲ aː m ˈb aː j
nyanyi	ɲ a ɲ i
nyendok	ɲ ə n . d o ʔ
Nyepi	ɲ ə ˈp i
nyiur	ˈɲ j u r
nyonya	ɲ o ɲ a
Nyonya	ɲ o ɲ a
o	o
o	o
O	o
O	o
oase	o ˈa s ə
oasis	ɔ . ˈa . s i s
obesitas	o b ɛ . s i . t a s
obi	o . b i
objektivitas	ɔ p d͡ʒ ɛ k t i ˈf i t a s
obrol	ˈɔ b r ɔ l
observasi	ɔ p̚ . s ə r . ˈv a . s i
obsidian	ɔ p . s i . ˈd i . a n
obstetri	ɔ b s ˈt ɛ t r i
ofensif	ˈɔ f e n s ɪ f
ogah	o . ɡ a h
oke	ɔ k e
oksidasi	ɔ k . s i . ˈd a . s i
oksimeter	ɔ k̚ s i ˈm ɛ t ə r
oktan	o k . t a n
oktana	o k . t a . n a
Oktober	ɔ k̚ . ˈt o . b ə r
olah	ˈɔ l a h
oligarki	o . l i . ˈɡ a r . k i
oligarkis	o . l i . ˈɡ a r . k ɪ s
Olimpiade	o . l ɪ m . p i . ˈa . d ə
ompol	ˈo m . p o l
onagata	o . n a . ɡ a . t a
onani	o . n a . n i
onderdil	o n . d ə r . d i l
ongkir	o ŋ ˈk i r
ongkos	o ŋ . k o s
onigiri	o . n i . ɡ i . r i
onsen	o n . s ɛ n
opium	ˈɔ p i ʊ m
oplos	o p̚ l o s
oplosan	o p . l o s . a n
optimalisasi	ɔ p t i m a l i ˈs a s i
orang	o . r a ŋ
orangtua	o . r a ŋ . t u . a
origami	o . r i . ɡ a . m i
ortopedi	ɔ r t o ˈp ɛ d i
ortu	o r . t u
osmoregulasi	ɔ s m o r e ɡ u ˈl a s i
otot	ˈɔ t ɔ t
ovarium	o v a ˈr i ʊ m
ovulasi	ɔ v u ˈl a s i
ovum	ˈɔ v ʊ m
pabrikasi	p a b r i ˈk a s i
pabrikasi	p a p̚ r i ˈk a s i
pacal	ˈp a . t͡ʃ a l
pacu	ˈp a . t͡ʃ u
pacuan	p a . ˈt͡ʃ u . a n
pada	ˈp a d a
padam	ˈp a d a m
padi	p a d i
padri	p a d r i
paduan	ˈp a d w a n
paduka	p a . d u . k a
padus	p a . d u s
pagelaran	p a . ɡ ə . l a . r a n
pagi	ˈp a ɡ i
pagu	p a ɡ u
paha	ˈp a h a
pahala	p a . h a . l a
paham	p a . h a m
pahlawan	p a h ˈl a w a n
pajanan	p a . ˈd͡ʒ a n . a n
pakaian	p a ˈk a j a n
paku	p a k u
pala	p a . l a
palang	ˈp a l a ŋ
palapa	p a . l a . p a
paleontologi	p a . l e . ɔ n . t o . ˈl o . ɡ i
Palestina	p a . l ɛ s . ˈt i . n a
palisade	p a l i ˈs a d ə
palla	ˈp a l l a
palu	p a . l u
Palu	p a . l u
palung	p a . l ʊ ŋ
pameget	p a . m ə . ɡ ə t
pamong	ˈp a . m ɔ ŋ
panas	p a . n a s
pandemi	p a n ˈd e m i
pandemik	p a n ˈd e m ɪ k
panduan	p a n . ˈd u . a n
panekuk	p a . n ə . k u k
pangkal	ˈp a ŋ k a l
pangkalan	p a ŋ ˈk a l a n
pangkat	ˈp a ŋ k a t̚
pangkuan	p a ŋ ˈk u a n
pangsit	p a ŋ . s i t
panir	ˈp a n ɪ r
panja	ˈp a n d͡ʒ a
panjang	ˈp a n d͡ʒ a ŋ
panko	p a n . k o
pantai	ˈp a n t a j
pantat	ˈp a n t a t̚
pantau	ˈp a n t a u̯
pap	p a p
papa	p a . p a
papa	p a . p a
papan	ˈp a p a n
papatong	p a ˈp a t ɔ ŋ
papir	ˈp a p ɪ r
parade	p a ˈr a d ə
paradoks	p a ˈr a d ɔ k s
paradoksal	p a r a ˈd ɔ k s a l
paradoksikal	p a r a d ɔ k ˈs i k a l
parah	ˈp a r a h
parak	ˈp a . r a ʔ
parang	ˈp a r a ŋ
pare	ˈp a r e
parit	ˈp a r ɪ t̚
paritas	p a . ˈr i . t a s
pariwisata	p a . r i . w i . s a . t a
parlemen	p a r l ə ˈm ɛ n
parlementer	p a r l ə m ɛ n t ɛ r
paro	ˈp a r o
paroki	p a . r o . k i
parpol	p a r . p o l
parsimoni	p a r . s i . ˈm o . n i
partikelir	p a r t i k ə l ɪ r
parturisi	p a r . t u . ˈr i . s i
partus	ˈp a r . t ʊ s
paru	ˈp ä . r u
parut	ˈp a . r ʊ t
parwa	ˈp a r w a
pasang	ˈp a . s a ŋ
pasaran	p a ˈs a r a n
pasir	p a s ɪ r
Paskah	p a s . k a h
pasokan	p a ˈs ɔ k a n
pasraman	p a s . r a . m a n
pastor	p a s t o r
patahan	p a ˈt a h a n
patik	ˈp a . t ɪ k
patiseri	p a . t i . s ə . ˈr i
patriarkat	p a . t r i . ˈa r . k a t̚
patriarki	p a . t r i . ˈa r . k i
patung	ˈp a t ʊ ŋ
paus	ˈp a ʊ s
payudara	p a j u ˈd a r a
PDIP	p ɛ d ɛ i ˈp ɛ
pecah	p ə ˈt͡ʃ a h
pecahan	p ə . t͡ʃ a . h a n
pecel	p ə . ˈt͡ʃ ə l
pecut	p ə . ˈt͡ʃ ʊ t
pecutan	p ə ˈt͡ʃ ʊ t a n
pedagogi	p e d a ˈɡ o ɡ i
peduli	p ə d u l i
pedupaan	p ə d u ˈp a a n
pegas	p ə . ˈɡ a s
pejabat	p ə d͡ʒ a b a t
pejagalan	p ə . d͡ʒ a . ˈɡ a l . a n
pejamu	p ə . ˈd͡ʒ a . m u
pejawat	p ə ˈd͡ʒ a w a t
pek	p ɛ k
pek	p ɛ k
peka	ˈp e . k a
pekan	p ə k a n
pekerjaan	p ə . k ə r . d ʒ a . ʔ a n
pekerti	p ə k ə r ˈt i
pelacur	p ə . l a . t͡ʃ ʊ r
peladen	p ə ˈl a d ɛ n
pelahiran	p ə . l a . ˈh ɪ r . a n
pelajar	p ə l . a . d͡ʒ a r
pelaku	p ə ˈl a k u
pelan	p ə ˈl a n
pelan	ˈp e l a n
pelanggar	p ə . ˈl a ŋ . ɡ a r
pelangi	p ə l a ŋ i
pelapukan	p ə . l a . ˈp ʊ k . a n
pelarian	p ə . l a . ˈr i . a n
pelatih	p ə ˈl a t ɪ h
pelatihan	p ə l a ˈt ɪ h a n
pelembapan	p ə . l ə m . ˈb a p . a n
pelepah	p ə . l ə . ˈp a h
pelepasan	p ə l ə ˈp a s a n
peler	p ə ˈl e r
pelonco	p ə ˈl ɔ n t͡ʃ o
pelopor	p ə ˈl o p ɔ r
peluk	p ə l ʊ k
pelumas	p ə ˈl u m a s
pemabuk	p ə m a b u k
pemacu	p ə . ˈm a . t͡ʃ u
pemain	p ə . m a i n
pemandian	p ə m a n ˈd i a n
pemanfaatan	p ə . m a n . f a . ˈa t . a n
pembaca	p ə m ˈb a t͡ʃ a
pembakuan	p ə m . b a . ˈk u . a n
pembangkang	p ə m ˈb a ŋ k a ŋ
pembelahan	p ə m b ə ˈl a h a n
pembentangan	p ə m . b ə n . ˈt a ŋ . a n
pemberitahuan	p ə m . b ə . r i . t a . ˈh u . a n
pemberontakan	p ə m b ə r ɔ n ˈt a k a n
pembilang	p ə m ˈb i l a ŋ
pembinaan	p ə m b i ˈn a a n
pembohong	p ə m . b o . h o n ɡ
pembunuh	p ə m b u n ʊ h
pembunuhan	p ə m b u ˈn u h a n
pemda	p ə m ˈd a
pemeriksaan	p ə m ə r ɪ k ˈs a a n
pemerintahan	p ə m ə r ɪ n ˈt a h a n
pemerkosaan	p ə . m ə r . k o . ˈs a . a n
pemerolehan	p ə . m ə r . ˈɔ l ɛ h . a n
pemeruman	p ə m ə ˈr u m a n
pemilik	p ə ˈm i l ɪ ʔ̚
pemkab	p ə m ˈk a p̚
pemkot	p ə m ˈk ɔ t̚
pemompaan	p ə m ɔ m ˈp a a n
pemprov	p ə m ˈp r ɔ p̚
pemrograman	p ɛ m r o ˈɡ r a m a n
pemufakatan	p ə m u f a ˈk a t a n
pemulangan	p ə . m u . ˈl a ŋ . a n
pemuliaan	p ə m u ˈl i a̯ a n
penagihan	p ə . n a . ˈɡ ɪ h . a n
penaksiran	p ə . n a k . ˈs ɪ r . a n
penakut	p ə . n a . k u t
penanda	p ə n a n d a
penanggalan	p ə n a ŋ ˈɡ a l a n
penangguhan	p ə n a ŋ ˈɡ ʊ h a n
pencemaran	p ə n . t͡ʃ ə . m a . r a n
pencitraan	p ə ŋ t͡ʃ i ˈt r a a n
pencucian	p ə n t͡ʃ u t͡ʃ iʲ a n
pendarahan	p ə n . d a . ˈr a h . a n
pendek	ˈp e n . d e k
pendekatan	p ə ŋ . d ə . ˈk a t . a n
penderita	p ə n d ə r i t a
pendeta	p ə n . d ɛ . t a
pendukung	p ə n ˈd u k ʊ ŋ
penegakan	p ə . n ə . ˈɡ a k . a n
penelitian	p ə . n ə . l i . ˈt i . a n
penera	p ə . n ə . r a
penerapan	p ə . n ə . ˈr a p . a n
penerbang	p ə n ə r ˈb a ŋ
penerbit	p ə n ə r ˈb ɪ t̚
penerimaan	p ə . n ə . r i . ˈm a . a n
penerus	p ə . n ə . ˈr ʊ s
pengabdian	p ə ŋ . a p . ˈd i . a n
pengacakan	p ə ŋ . ˈa t͡ʃ a k . a n
pengacau	p ə ˈŋ a t͡ʃ a u̯
pengadaan	p ə ŋ . ˈa d a . a n
pengairan	p ə ŋ . a . ʔ ɪ r . a n
pengaktifan	p ə ŋ a k ˈt i f a n
pengaman	p ə ŋ ˈa m a n
pengamanan	p ə ŋ ˈa m a n a n
penganggaran	p e ŋ . a ŋ . ˈɡ a r . a n
pengangkat	p ə ŋ . ˈa ŋ . k a t̚
penganiaya	p ə ŋ a n i a j a
penganiayaan	p ə ŋ a n i a j a a n
penganjur	p ə ŋ ˈa n d͡ʒ ʊ r
pengaturan	p ə ŋ a ˈt ʊ r a n
pengawas	p ə ŋ ˈa w a s
pengawasan	p ə ŋ a ˈw a s a n
pengecaman	p ə . ŋ ə . ˈt͡ʃ a m . a n
pengelasan	p ə ŋ ə ˈl a s a n
pengelompokan	p ə . ŋ ə . l ɔ m . ˈp ɔ k . a n
pengeluaran	p ə ŋ ə ˈl u a r a n
pengembang	p ə ŋ ə m ˈb a ŋ
pengen	p ɛ . ŋ ɛ n
pengenalan	p ə ŋ ə ˈn a l a n
pengendali	p ə . ŋ ə n . ˈd a . l i
penggalian	p ə ŋ ˈɡ a l i a n
penggiling	p ə ŋ . ɡ ɪ . l ɪ ŋ
pengguna	p ə ŋ ˈɡ u n a
penghakiman	p ə ŋ h a ˈk ɪ m a n
penghambat	p ə ŋ . ˈh a m . b a t
penghancuran	p ə ŋ h a n ˈt͡ʃ ʊ r a n
penghinaan	p ə ŋ h i ˈn a a n
penghulu	p ə ŋ . ˈh u . l u
pengin	p ɛ . ŋ i n
pengindonesiaan	p ə ŋ ɪ n d o n ɛ ˈs j a̯ a n
pengodean	p ə . ŋ o . ˈd ə . a n
pengoplos	p ɘ ŋ . o p . l o s
penguat	p ə ˈŋ u a t
penguatan	p ə ŋ u ˈa t̚ a n
pengucapan	p ə ŋ . u . ˈt͡ʃ a p . a n
pengudaraan	p ə ŋ u d a ˈr a a n
penguji	p ə ŋ . ˈʊ d͡ʒ i
pengumuman	p ə ŋ u ˈm ʊ m a n
pengungsi	p ə ŋ . ˈʊ ŋ . s i
pengurangan	p ə ŋ u ˈr a ŋ a n
pengusaha	p ə ŋ u ˈs a h a
penilaian	p ə n i ˈl a i̯ a n
peningkatan	p ə . n ɪ ŋ . ˈk a t . a n
penjagaan	p ə n ˈd͡ʒ a . ɡ a . a n
penjagaan	p ə n ˈd͡ʒ a . ɡ a ʔ a n
penjahat	p ə n ˈd͡ʒ a h a t̚
penjelajah	p ə n d͡ʒ ə ˈl a d͡ʒ a h
penolong	p ə . ˈn ɔ . l ɔ ŋ
pentana	p ɛ n . t a . n a
penuntut	p ə . n u n . t ʊ t
penurunan	p ə . n u . ˈr ʊ n . a n
penyakit	p ə ɲ a k ɪ t
penyamaran	p ə ˈɲ a . m a . r a n
penyampelan	p ə . ɲ a m . p ə l . ˈa n
penyangkalan	p ə . ɲ a ŋ . ˈk a l . a n
penyearah	p ə . ɲ ə . ˈa . r a h
penyebut	p ə ɲ ə ˈb ʊ t̚
penyederhanaan	p ə . ɲ ə . d ə r . h a . ˈn a . a n
penyekatan	p ə ɲ ə ˈk a t a n
penyelamatan	p ə . ɲ ə . l a . ˈm a t . a n
penyelenggaraan	p ə . ɲ ə . l ə ŋ . ɡ a . ˈr a . a n
penyesuaian	p ə ɲ ə s u ˈa i̯ a n
penyiksaan	p ə . ɲ ɪ k . ˈs a . a n
penyimpangan	p ə ɲ ɪ m ˈp a ŋ a n
pepet	p ə . ˈp ə t
pepet	ˈp ɛ . p ɛ t
perabuan	p ə r ˈa b u a n
peradaban	p ə r ˈa d a p a n
peradilan	p ə r . a . ˈd ɪ l . a n
perahu	p ə ˈr a h u
perak	ˈp e . r a k
Perak	ˈp ɛ . ɾ ʌ ʔ
perambah	p ə r a m b a h
perang	p ə ˈr a ŋ
peranti	p ə ˈr a n t i
perasaan	p ə r a ˈs a a n
perasat	p ə . ˈr a . s a t
peraturan	p ə r a t u r a n
perawan	p ə ˈr a w a n
perawat	p ə . r a . w a t
perbaikan	p ə r . b a . ˈɪ k . a n
perban	p ə r . b a n
perbani	p ə r . ˈb a . n i
perbedaan	p ə r . b e . ˈd a . a n
perbuatan	p ə r . b u . a . t a n
perbuatan	p ə r ˈb w a . t a n
percobaan	p ə r t͡ʃ o ˈb a a n
percuma	p ə r t͡ʃ u m a
perdana	p ə r d a n a
perdarahan	p ə r . d a . ˈr a h . a n
perdata	p ə r ˈd a t a
perdikan	p ə r ˈd i k a n
perdom	p ə r ˈd ɔ m
peremajaan	p ə . r ə . m a . ˈd͡ʒ a . a n
perembesan	p ə . r ə m . b ə s . ˈa n
perengkahan	p ə . r ə ŋ . ˈk a h . a n
peres	ˈp ɛ . r ɛ s
performer	p ə r ˈf ɔ r m ə r
pergelaran	p ə r . ɡ ə . ˈl a r . a n
pergi	p ə r . ɡ i
perhati	p ə r ˈh a t i
perhatian	p ə r . h a . ˈt i . a n
perhentian	p ə r ˈh ə n t j a n
peria	p ə ˈr i a̯
peringatan	p ə r ˈɪ ŋ a t̚ a n
perintah	p ə ˈr ɪ n t a h
periuk	p ə ˈr i ʊ k
perjaka	p ə r . ˈd͡ʒ a . k a
perjanjian	p ə r . d͡ʒ a n . ˈd͡ʒ i . a n
perkara	p ə r . k a . r a
perkataan	p ə r . k a . ˈt a . a n
perkebunan	p ə r . k ə . ˈb ʊ n . a n
perlengkapan	p ə r . l ə ŋ . ˈk a p . a n
permainan	p ə r ˈm a i . n a n
permanen	p ə r ˈm a n ɛ n
permukaan	p ə r . m u . k a . a n
permukaan	p ə r ˈm u . k a ʔ a n
permusyawarahan	p ə r m u ʃ a w a ˈr a h a n
permutasi	p ə r m u ˈt a s i
pernah	p ə r . n a h
pernyataan	p ə r . ɲ a . ˈt a . a n
perobatan	p ə r ˈɔ b a t a n
perolehan	p ə r o ˈl ɛ h . a n
perpaduan	p ə r p a ˈd u a n
perpajakan	p ə r . p a . ˈd͡ʒ a k . a n
perpanjangan	p ə r p a n ˈd͡ʒ a ŋ a n
perpeloncoan	p ə r p ə l ɔ n ˈt͡ʃ o a n
perpindahan	p ə r p ɪ n ˈd a h a n
persada	p ə r . s a . d a
persalinan	p ə r . s a . ˈl ɪ n . a n
persatuan	p ə r s a ˈt u a n
persediaan	p ə r . s ə . d i . ˈa . a n
persembahan	p ə r s ə m ˈb a h a n
persen	p ə r ˈs ɛ n
persentil	p ə r . ˈs ɛ n . t ɪ l
persenyawaan	p ə r s ə ɲ a ˈw a a n
perserikatan	p ə r . s ə . r i . ˈk a t . a n
persiapan	p ə r . s i . ˈa p . a n
persidangan	p ə r s i ˈd a ŋ a n
persik	ˈp ɛ r . s ɪ k
persneling	p ə r . s n e . l i ŋ
persneling	p ə r . s ə . n e . l i ŋ
personalitas	p ə r s o n a ˈl i t a s
pertahanan	p ə r t a ˈh a n a n
pertambangan	p ə r t a m ˈb a ŋ a n
pertempuran	p ə r . t ə m . ˈp ʊ r . a n
pertemuan	p ə r . t ə . ˈm u . a n
pertiwi	p ə r . ˈt i . w i
pertumbuhan	p ə r t ʊ m ˈb ʊ h a n
perulangan	p ə r . ˈʊ l a ŋ . a n
perunggu	p ə . ˈr ʊ ŋ . ɡ u
perut	p ə . ˈr ʊ t̚
perwakilan	p ə r w a ˈk ɪ l a n
pesawat	p ə . ˈs a . w a t̚
peserta	p ə s ə r ˈt a
pesumo	p ə . s u . m o
peta	p ə ˈt a
petahana	p ə t a ˈh a n a
petanda	p ə . ˈt a n . d a
petani	p ə . ˈt a . n i
peternak	p ə t ə r ˈn a k
petik	p ə . ˈt ɪ k
petis	p ə ˈt ɪ s
Petrus	ˈp ɛ t r ʊ s
petrus	p ə ˈt r ʊ s
peubah	p ə ˈʊ b a h
pewarna	p ə . ˈw a r . n a
PHBS	p e h a ˈb e ɛ s
piadah	p i ˈa d a h
pialang	ˈp ɪ j a l a ŋ
piama	p i ˈa m a
picu	p i t͡ʃ u
pidana	p i ˈd a n a
pihak	ˈp i h a ʔ
piket	p i k ɛ t̚
pikir	ˈp i k ɪ r
piktogram	p ɪ k . ˈt o . ɡ r a m
pilot	ˈp i l ɔ t̚
pimpinan	p ɪ m . ˈp ɪ n . a n
pinta	ˈp i n t a
pintu	ˈp ɪ n t u
pion	p i . o n
pionir	p i o n ɪ r
pipi	ˈp i . p i
piranti	p i ˈr a n t i
pirus	ˈp i r ʊ s
pistol	ˈp ɪ s t ɔ l
pit	ˈp ɪ t
pita	p i . t a
plafon	ˈp l a . f ɔ n
plafon	p ə̆ ˈl a . f ɔ n
plak	p l a k
plan	p l a n
planetarium	p l a . n e . t a . ˈr i . ʊ m
planologi	p l a n o ˈl o ɡ i
plastisitas	p l a s t i ˈs i t a s
platelet	p l a ˈt e l ə t̚
pleidoi	ˈp l e i . d o i̯
pleno	ˈp l e n o
plot	ˈp l ɔ t̚
PM	ˈp e ɛ m
pokok	ˈp o k ɔ k̚
pola	ˈp o l a
polah	ˈp o l a h
polen	ˈp o l ə n
polimer	p o . ˈl i . m ɛ r
polimerisasi	p o . l i . m e . r i . ˈs a . s i
polis	p o . l ɪ s
ponakan	p o ˈn a k a n
ponpes	ˈp ɔ n p ə s
ponsel	p o n s ɛ l
populasi	p o p u ˈl a s i
poros	ˈp ɔ . r ɔ s
porus	ˈp o . r ʊ s
posting	ˈp ɔ s t ɪ ŋ
potongan	p ɔ ˈt ɔ ŋ a n
potret	p o t r e t
PPDB	p e . p e . d e . b e
PR	p ɛ . ɛ r
prabu	p r a . b u
Prakerta	p r a k ə r ˈt a
prakiraan	p r a . k i . ˈr a . a n
praktek	ˈp r a k̚ t ɛ k̚
praktik	ˈp r a k̚ t ɪ k̚
pramulansia	p r a . m u . l a n . s i a
pramuterbang	p r a m u ˈt ə r b a ŋ
pramuwreda	p r a . m u . w r ə . d a
pranatal	p r a . ˈn a . t a l
praperadilan	p r a . p ə r . a . ˈd ɪ l . a n
prasada	p r a . s a . d a
prasangka	p r a ˈs a ŋ k a
prei	p r e i
prematur	p r e . ˈm a . t ʊ r
presentasi	p r e s ɛ n ˈt a s i
presipitat	p r e s i ˈp i t a t̚
pria	ˈp r i a
pria	p ə r ˈj a
pribadi	p r i . ˈb a . d i
prima	ˈp r i . m a
prinsip	ˈp r ɪ n s ɪ p̚
prinsipiel	p r ɪ n s i ˈp i ə l
prioritas	p r i o ˈr i t a s
produk	ˈp r o . d ʊ k
produk	ˈp r o . d a k
profase	p r o ˈf a s ə
profesor	p r o ˈf ɛ . s ɔ r
proklamasi	p r o k l a ˈm a s i
promovendus	p r o m o ˈv ɛ n d ʊ s
pronomina	p r o . n o . ˈm i . n a
propana	p r o . p a . n a
proporsi	p r o ˈp ɔ r s i
proses	ˈp r o s ɛ s
protein	p r o ˈt e ɪ n
provinsi	p r o ˈv i n s i
provos	ˈp r o v ɔ s
proyek	ˈp r o . j ɛ k
proyeksi	p r o ˈj ɛ k s i
psikiater	p ə s i k iʲ a t ə r
psikiater	s i k iʲ a t ə r
psikolog	p ə s i ˈk o l ɔ k̚
psikologi	p ə s i k o ˈl o ɡ i
psikologis	p ə s i k o ˈl o ɡ ɪ s
PSK	p ɛ ˈɛ s k a
PTM	p e ˈt e ɛ m
puas	ˈp u a s
publikasi	p u b l i ˈk a s i
publisitas	p u b l i ˈs i t a s
pucat	ˈp u . t͡ʃ a t
pugar	ˈp u . ɡ a r
puing	ˈp u ɪ ŋ
puja	p u . d͡ʒ a
pujasera	p u d͡ʒ a s ə ˈr a
puji	p u . d͡ʒ i
pujian	p u j i a n
pukat	ˈp u k a t
pulang	ˈp u l a ŋ
pulau	ˈp u l a u̯
pulih	ˈp u l ɪ h
pulut	ˈp u l ʊ t̚
punca	ˈp ʊ n . t͡ʃ a
punia	p u . n i a̯
puntung	p ʊ n t ʊ ŋ
punya	ˈp u ɲ a
pupuk	ˈp ʊ p ʊ ʔ
pupus	ˈp u p ʊ s
puputan	p u . ˈp ʊ t . a n
pura	p u . r a
puri	p u . r i
purina	p u . ˈr i . n a
pustaha	p ʊ s ˈt a h a
putaran	p u . ˈt a . r a n
putau	ˈp u . t a u̯
putus	p u t ʊ s
q	k
q	k i
qanun	q a n u n
qasar	ˈq a . s a r
qasar	ˈk a . s a r
qiraah	k i ˈr a a h
raba	ˈr a b a
rabies	r a . ˈb i . ɛ s
Rabu	r a . b u
raden	ˈr a . d ɛ n
radikalisasi	r a d i k a l ˈɪ s a s i
radikalisme	r a d i k a l ˈɪ s m ə
radius	r a ˈd i ʊ s
raga	r a . ɡ a
ragil	ˈr a . ɡ ɪ l
ragu	ˈr a ɡ u
rahayu	r a ˈh a j u
rahmat	r a h m a t
raja	ˈr a d͡ʒ a
raksasa	r a k ˈs a s a
rakyat	ˈr a k j a t
rakyu	ˈr a ʔ j u
ralat	ˈr a l a t̚
ramah	ˈr a m a h
ramai	ˈr a m a i̯
ramal	r a m a l
ramal	r a m a l
ramalan	r a . ˈm a l . a n
rambut	ˈr ä m . b u t̪̚
rames	ˈr a . m ə s
rana	ˈr a . n a
rancang	ˈr a n . t͡ʃ a ŋ
ranjang	ˈr a n . d͡ʒ a ŋ
ransel	ˈr a n . s ə l
rantau	ˈr a n . t a u̯
rapat	ˈr a p a t
rapuh	ˈr a p u h
rasa	r a . s a
rase	ˈr a s e
rasio	ˈr a s i o̯
rasional	r a s i ˈo n a l
rasisme	r a ˈs ɪ s m ə
rasuah	r a . s u . a h
ratu	ˈr a t u
rawak	ˈr a . w a k
rawi	r a w i
realitas	r e . a . l i . t a s
reanimasi	r e a n i m a s i
reboisasi	r e b o i ˈs a s i
rebung	r ə ˈb ʊ ŋ
reda	ˈr e . d a
reda	r ə . ˈd a
redaman	r ə . ˈd a m . a n
reduksi	r e ˈd ʊ k s i
reduksionisme	r e . d ʊ k . s i . o . ˈn ɪ s . m ə
redundansi	r e . d ʊ n . ˈd a n . s i
refleksi	r e . ˈf l ɛ k . s i
reforestasi	r e f o r ɛ s ˈt a s i
registri	r e . ˈɡ ɪ s . t r i
regu	r ə ˈɡ u
reguler	r ɛ ˈɡ u l ɛ r
rehabilitasi	r e h a b i l i ˈt a s i
rekayasa	r e k a ˈj a s a
rekonsiliasi	r e . k ɔ n . s i . l i . ˈa . s i
rekrutmen	r e ˈk r ʊ t m ə n
reksa	r ə k . s a
rektor	r ɛ k . t o r
rektum	ˈr ɛ k̚ t ʊ m
rela	ˈr e . l a
relai	ˈr e . l a i̯
relai	r ə . ˈl a i̯
relai	r ə . ˈl a i̯
relai	r ə . ˈl a i̯
relevansi	r e . l ə . ˈv a n . s i
reliabel	r e l i ˈa b ə l
reliabilitas	r e l i a b i ˈl i t a s
relikui	r ɛ ˈl i k u i̯
rem	ˈr ɛ m
remas	r ə . ˈm a s
rembes	ˈr ɛ m b ɛ s
rembes	r ə m ˈb ə s
rembes	ˈr ɛ m b ə s
rembesan	r ə m b ə s ˈa n
rendah	r ə n d a h
rengo	r e n . ɡ o
renta	ˈr ɛ n t a
renta	r ə n ˈt a
rentang	r ə n ˈt a ŋ
rentang	ˈr ɛ n t a ŋ
renten	ˈr ɛ n t ə n
reproduksi	r e p r o ˈd ʊ k s i
reputasi	r e p u ˈt a s i
resam	r ə . ˈs a m
resam	r ə . ˈs a m
resep	r ə ˈs ɛ p
reservoir	r ə s ɛ r ˈf o ɪ r
reservoir	r e s ə r ˈf o a r
reses	ˈr e . s ɛ s
resesi	r ɛ ˈs ɛ s i
residensial	a b o n ə m ɛ n
resistans	r e ˈs ɪ s t a n s
resistansi	r e s ɪ s ˈt a n s i
resistensi	r e s ɪ s ˈt ɛ n s i
resistor	r e ˈs ɪ s t ɔ r
resleting	r e s . l ɛ . t i ŋ
resmi	r ə s . m i
resmi	r ə s . m i
resonansi	r e . s o . ˈn a n . s i
resorpsi	r e ˈs ɔ r p s i
responden	r ɛ s ˈp ɔ n d ɛ n
resusitasi	r e s u s i t a s i
retas	r ə ˈt a s
retensi	r ə . t ɛ n . s i
retorika	r e t o ˈr i k a
retoris	r e ˈt o r ɪ s
rezeki	r ə . z ə . ˈk i
RI	ˈr i
ri	r i
riadat	r i ˈa d a t̚
riba	ˈr i b a
ribosom	r i ˈb o s ɔ m
ribu	ˈr i b u
rijsttafel	r ɛ i̯ s t a f ə l
rijsttafel	r ɛ s t a f ə l
rindang	ˈr ɪ n d a ŋ
ringkas	ˈr ɪ ŋ k a s
riol	ˈr i . ɔ l
risalah	r i ˈs a l a h
risiko	r i ˈs i k o
riskan	r i s . k a n
risoto	r i ˈs o t o
ritsleting	r i t . s l ə . t i ŋ
ritsleting	r i t s . l ə . t i ŋ
ritsleting	r i t s . s l ə . t i ŋ
rogol	ˈr ɔ . ɡ ɔ l
rokade	r o ˈk a d ə
rokok	ˈr o k o ʔ
Roma	ˈr o m a
roman	ˈr o . m a n
romansa	r o ˈm a n s a
romantik	r o ˈm a n t ɪ k
romantika	r o m a n ˈt i k a
romantis	r o ˈm a n t ɪ s
romo	ˈr o m o
romusa	r o . m u . s a
romusha	r o . m u . ʃ a
romusya	r o . m u . ʃ a
rongga	ˈr ɔ ŋ . ɡ ä
ronsen	ˈr ɔ n s ə n
rontgen	ˈr ɔ n t ɡ ə n
rontgen	ˈr ɔ n s ə n
rotan	ˈr o . t a n
RS	ɛ r . ɛ s
ruang	ˈr u a ŋ
rujak	ˈr u d͡ʒ a ʔ
rumah	ˈr u m a h
Rumania	r u ˈm a n i a̯
rumput	ˈr ʊ m p ʊ t̚
rumus	ˈr u m ʊ s
rungu	ˈr u . ŋ u
rusak	r u . s a k̚
rusak	r u . s a ʔ
Rusia	ˈr u s i a̯
rusuk	r u . s ʊ k
s'lalu	s l a . l u
sa	s a
saat	s a . ʔ a t
sabar	ˈs a b a r
sabi	s a . b i
sabit	ˈs a b ɪ t̚
sabitan	s a . ˈb ɪ t̚ . a n
sabo	s a . b o
Sabrina	ˈs a b r i n a
sabun	ˈs a b ʊ n
sabung	s a . b ʊ ŋ
sadar	s a . d a r
sadeu	ˈs a d ɘ
sadir	ˈs a d ɪ r
sadu	s a . d u
sagu	ˈs a ɡ o
sahaya	s a ˈh a j a
saja	ˈs a d͡ʒ a
Saka	s a k a
sake	s a . k e
sakelar	s a . k ə . l a r
SAKIP	ˈs a k ɪ p̚
sakit	ˈs a k ɪ t̚
sakti	s a k . t i
sal	s a l
sala	s a l a
salah	ˈs ä . l ä h
salam	ˈs a l a m
salim	ˈs a l ɪ m
salju	ˈs a l d͡ʒ u
salpeter	s a l . p ɛ . t ə r
Salsabila	ˈs a l s a b i l a
sama	s a . m a
sambil	ˈs a m b ɪ l
sambilan	s a m . ˈb ɪ l . a n
sambungan	s a m . ˈb ʊ ŋ . a n
samcan	s a m . t͡ʃ a n
sami	ˈs a m i
sampah	ˈs a m p a h
sampai	s a m p a i̯
samper	s a m p ə r
sampir	ˈs a m p ɪ r
sampling	ˈs a m p l ɪ ŋ
samsek	s a m . s ə k
samudra	s a ˈm u d r a
samurai	s a . m u . r a i
sana	ˈs a n a
sanak	s a . n a ʔ
sanawiah	s a n a ˈw i a h
sancan	s a ɲ . t͡ʃ a n
sancan	s a n . t͡ʃ a n
sandang	ˈs a n d a ŋ
sandar	ˈs a n d a r
sandung	ˈs a n d ʊ ŋ
sangat	s a . ŋ a t
sange	s a . ŋ ɛ
sange	s a . ŋ ɛ ʔ
sangga	s a ŋ ɡ a
sanggah	ˈs a ŋ ɡ a h
sanggul	s a ŋ . ɡ ʊ l
sangka	s a ŋ . k a
sangkut	s a ŋ k ʊ t
sangsi	s a ŋ . s i
sanksi	s a ŋ . s i
santap	ˈs a n . t a p̚
sapa	ˈs a . p a
sapi	ˈs a . p i
sapu	ˈs a . p u
saputangan	ˈs ä p u ˌt ä ŋ a n
sarana	s a . r a . n a
sarapan	s a ˈr a p̚ a n
sarasehan	s a . r a . ˈs ɛ h . a n
Sarawak	s a ˈr a w a ʔ
Sarawak	s ə ˈr a w a ʔ
sarden	ˈs a r d ɛ n
sarkas	ˈs a r k a s
sarkasme	s a r ˈk a s m ə
sarkastis	s a r ˈk a s t ɪ s
sarung	s a r ʊ ŋ
sasana	s a . s a . n a
saset	ˈs a s ɛ t
satah	ˈs a t a h
satgas	ˈs a t ɡ a s
satori	s a . t o . r i
satu	ˈs ä . t̪ u
satwa	ˈs a t̚ w a
saudara	s a u̯ d a r a
saudari	s a u̯ d a r i
sayang	ˈs a j a ŋ
sayap	ˈs a j a p̚
sayur	s a j u r
sebar	s ə ˈb a r
sebentar	s ə ˈb ə n t a r
secang	s ə . t͡ʃ a ŋ
sedang	s ə ˈd a ŋ
sedawa	s ə . d a . w a
sedot	s ə . ˈd ɔ t
segara	s ə ˈɡ a r a
segel	s ɛ ɡ ə l
segitiga	s ə . ɡ i . t i . ɡ a
seharian	s ə . h a . r i . a n
seharian	s ə . h a . r i . j a n
sehat	s ɛ h a t̚
sein	s e ɪ̯ n
seinendan	s e i . n e n . d a n
seka	ˈs ɛ k a
seka	s ə ˈk a
sekak	s ə . k a k
sekali	s ə . k a . l i
sekam	s ə . ˈk a m
sekarang	s ə ˈk a r a ŋ
sekarang	ˈs k a r a ŋ
sekat	s ə . ˈk a t̚
seko	s e . k o
seko	s ɛ . k o
seko	s ə . k o
sekong	s e . k o ŋ
sekresi	s ə ˈk r e s i
sekring	ˈs e k r ɪ ŋ
sekrup	s ə . k r u p
seksi	s ɛ k . s i
sekum	s ə ˈk ʊ m
sekunder	s ə ˈk ʊ n . d ɛ r
sela	ˈs e . l a
sela	ˈs e . l a
sela	ˈs e . l a
sela	ˈs e . l a
sela	s ə . ˈl a
selada	s a l a d a
selak	ˈs e . l a k
selak	s ə . ˈl a k
selak	s ə . ˈl a k
selaka	s ə . ˈl a . k a
selalu	s ə l a l u
selang	s ə ˈl a ŋ
Selasa	s ə ˈl a s a
selo	ˈs ɛ l o
semah	s ə ˈm a h
semak	s ə ˈm a ʔ
semak	s ə ˈm a ʔ
semak	ˈs e . m a ʔ
semalaman	s ə . m a . l a . m a n
semalaman	s ə . m a . l a m . a n
semalem	s ə . m a . l ə m
semaleman	s ə . m a . l ə . m a n
semang	s e ˈm a ŋ
semangka	s ə . m a ŋ . k a
semaya	s ə ˈm a j a
semayam	s ə ˈm a j a m
sembilan	s ə m . ˈb i . l ä n
sembrono	s ə m . ˈb ə̆ r o . n o
sembrono	s ə m ˈb r ɔ n ɔ
sembuh	s ə m ˈb ʊ h
semen	s ə ˈm ɛ n
semen	ˈs ɛ m ɛ n
semenanjung	s ə m ə ˈn a n d͡ʒ ʊ ŋ
sementara	s ə m ə n ˈt a r a
seminar	s ə ˈm i n a r
seminar	s ə ˈm i n a r
seminari	s ɛ m i ˈn a r i
semir	s ə ˈm i r
semong	s ə ˈm ɔ ŋ
sempena	s ə m . p ə . ˈn a
sempoa	s ə m p o a
sempurna	s ə m . p u r . n a
semua	s ə . m u . a
semuka	s ə . ˈm u . k a
senandung	s ə ˈn a n d ʊ ŋ
senantiasa	s ə n a n t i ˈa s a
senarai	s ə . ˈn a . r a i̯
sendawa	s ə n . d a . w a
sendratari	s ə n . d r a . t a . r i
sengkar	s ə ŋ ˈk a r
sengsai	s ɛ ŋ . s a i
sengsai	s ə ŋ . s a i
sengsara	s ə ŋ . s a . r a
seniman	s ə ˈn i m a n
Senin	s ə . ˈn ɪ n
senjang	s ə n . d͡ʒ a ŋ
sensei	s e n . s e i
sensitivitas	s ɛ n s i t i ˈv i t a s
senter	ˈs ɛ n t ə r
sentimen	s ɛ n . ˈt i . m ɛ n
sentosa	s ə n . t o . s a
sentral	ˈs ɛ n t r a l
sentralistis	s ɛ n t r a ˈl ɪ s t ɪ s
sentul	s ə n . ˈt ʊ l
seorang	s ə . o . r a ŋ
sepak	ˈs e . p ʌ k̚
sepak	s ə ˈp a k̚
sepak	s ə ˈp a k̚
sepang	s ə p a ŋ
sepatu	s ə . p a . t u
sepeda	s ə ˈp ɛ . d a
seperti	s ə p ə r t i
sepi	s ə ˈp i
sepong	s ə . p o ŋ
seprai	s ə p . r a i
seprei	s ə p . r e i
September	s ɛ p̚ . ˈt ɛ m . b ə r
sepuh	s ə . ˈp ʊ h
sepupu	s ə p u p u
sepur	s ə ˈp u r
serampang	s ə ˈr a m p a ŋ
seratus	s ə ˈr a t ʊ s
serdadu	s ə r ˈd a d u
serdawa	s ə r . d a . w a
seremoni	s e . r e . m o . n i
seri	ˈs e . r i
seri	s ə . ˈr i
serikat	s ə ˈr i k a t
serius	s ə . ˈr i . ʊ s
serius	s ɛ . ˈr i . ʊ s
serong	ˈs ɛ r ɔ ŋ
seronok	s ə . ˈr o . n ɔ ʔ
sertifikat	s e r t i f i k a t
sertifikat	s e r t i p i k a t
seru	s ə ˈr u
serundeng	s ə . ˈr ʊ n . d ɛ ŋ
sesak	s ə . ˈs a k
setempat	s ə t ə m ˈp a t̚
seterika	s ə . t ə . r i . k a
setolop	s ə ˈt ɔ l ɔ p
setra	s ɛ t . r a
setra	s ɛ . t r a
setrap	s ə t . r a p
setrum	s ə t . r ʊ m
setuju	s ə . t u . d͡ʒ u
seudati	s ɘ ˈd a t i
sewu	s e . w u
Shinto	ʃ i n . t o
shogun	ʃ o . ɡ u n
SHUN	ɛ s h a ˈu ɛ n
si	s i
sialan	s i . a . l a n
siang	s i . a ŋ
siasat	ˈs j a s a t
siber	ˈs i b ə r
sijil	s i d͡ʒ ɪ l
silabis	s i . ˈl a . b ɪ s
silam	s i . l a m
silet	ˈs i l ɛ t̚
silsilah	s ɪ l ˈs i l a h
siluet	s i . ˈl u . ɛ t
SIM	ˈs ɪ m
sima	ˈs i . m a
simak	ˈs i m a ʔ
simpanan	s i m p a n a n
simpangan	s ɪ m . ˈp a ŋ . a n
simposium	s ɪ m . p o . ˈs i . ʊ m
sinden	ˈs ɪ n . d ɛ n
sinergi	s i . ˈn ɛ r . ɡ i
Singapura	s i ŋ a ˈp u r a
singgah	ˈs ɪ ŋ ɡ a h
singgasana	s i ŋ . ɡ a . s a . n a
singse	s i ŋ . s ə
sini	ˈs i n i
sinse	s i n . s e
sintas	ˈs ɪ n t a s
sinyal	s i ɲ a l
sinyal	s i ɲ a r
siomai	s i ˈo m a j
siomay	ˈs j o m a j
sipil	s i p ɪ l
siram	ˈs i . r a m
sirkuler	s ɪ r ˈk u l ɛ r
sistemis	s ɪ s . ˈt e . m ɪ s
siswa	ˈs ɪ s w a
sita	s i t a
sitoplasma	s i t o ˈp l a s m a
situasional	s i t u a s i ˈo n a l
skala	s ə̆ k a l a
skalar	s k a . l a r
skema	s ə k e m a
skim	s ə k ɪ m
skor	s k o r
Skotlandia	s k ɔ t ˈl a n d i a̯
slalu	s l a . l u
slang	s ə l a ŋ
slank	s l ɑ ŋ k
slendro	s l ɛ n . d r o
slogan	s ə̆ l o . ɡ a n
SMA	ɛ s . ɛ m . ʔ a
SMA	ɛ s . ɛ m . a
SMK	ɛ s . ˈɛ m . k a
soal	ˈs o . ʔ a l
soang	s o a̯ ŋ
soba	s o . b a
sofa	ˈs o f a
soleh	ˈs o . l ɛ h
solidaritas	s o . l i . d a . ˈr i . t a s
songket	s o ŋ k ɛ̀ t
sopir	ˈs o p ɪ r
sore	s o . r e
sosialisme	s o s i a l ˈɪ s m ə
sosok	ˈs o s ɔ ʔ
soto	s o . t o
spanduk	s ə p a n d ʊ k̚
spaning	s p a . n i ŋ
spesies	s p ɛ . ˈs i . ɛ s
spesifik	s p ɛ ˈs i f ɪ k̚
spesifisitas	s p e s i f i ˈs i t a s
spoelhoek	s p ʊ l h ʊ k̚
sponsor	ˈs p ɔ n . s ɔ r
sporadis	s p o . ˈr a . d ɪ s
sprei	s ə p . r e i
sprint	ˈs p r ɪ n t
SR	ʔ ɛ s . ʔ ɛ r
sri	s ə r i
stadion	s t a ˈd i ɔ n
stadium	s t a ˈd i ʊ m
staf	s t a f
standardisasi	s t a n . d a r . d i . s a . s i
standarisasi	s t a n . d a . r i . s a . s i
standarisasi	s t a n . d a r . i . s a . s i
stasi	s t a s i
stasioner	s t a s i ˈo n ɛ r
steker	a b o n ə m ɛ n
step	s ə t ɛ p
stereotipe	s t e r e o ˈt i p ə
sterilisasi	s t e . r i . l i . ˈs a . s i
stoples	ˈs t ɔ p l ɛ s
stoples	s ə ˈt ɔ p l ɛ s
struktur	ˈs t r ʊ k . t ʊ r
suami	ˈs u a̯ . m i
suara	s u . ˈw ä . r ä
subang	ˈs u b a ŋ
subjek	s u b . d͡ʒ ɛ k
sublimasi	s ʊ p l i ˈm a s i
sublimasi	s u b l i ˈm a s i
substitusi	s ʊ p . s t i . ˈt u . s i
subuco	s u . b u . t͡ʃ o
subyek	s u b . j ɛ k
subyek	s u b . j ə k
suci	s u . t͡ʃ i
suda	ˈs u d a
sudah	ˈs u d a h
sudoku	s u . d o . k u
sudra	ˈs ʊ t . r a
sudra	ˈs u . d r a
sudut	ˈs u . d ʊ t
suf	ˈs ʊ f
suiseki	s u i . s e . k i
sujud	ˈs u d͡ʒ ʊ t̚
suka	ˈs u k a
sukarela	s u k a r e l a
suket	ˈs u k ə t̚
suket	ˈs u k ə t̚
sukma	ˈs ʊ ʔ m a
sulfur	ˈs ʊ l . f ʊ r
sulit	ˈs u l ɪ t̚
Sulut	s u . l u t
Sumatera	s u ˈm a t ə r a
sumatif	s u . ˈm a . t ɪ f
Sumbar	ˈs u m b a r
sumber	s ʊ m . b ə r
sumbu	ˈs ʊ m . b u
sumo	s u . m o
sumuran	s u ˈm u r a n
Sumut	ˈs u m u t
Sunda	ˈs ʊ n d a
sungai	s u ŋ a i̯
sungkit	s ʊ ŋ k ɪ t
sungsang	ˈs ʊ ŋ s a ŋ
sungut	ˈs u ŋ ʊ t
supaya	s u ˈp a j a
supel	ˈs u . p ə l
suplai	ˈs ʊ p l a i̯
Surabaya	s u r a ˈb a j a
Surakarta	s u r a k a r t a
surat	s u . r a t
surga	ˈs ʊ r ɡ a
Suriname	s u . r i . ˈn a . m ə
survei	ˈs ʊ r . v e i̯
surya	s u r . j a
suster	s u s . t ə r
susuk	ˈs u s ʊ ʔ
susyi	s u . ʃ i
sutra	s u . t r a
suvenir	s u v ə ˈn ɪ r
swafoto	s w a . f o . t o
swakriya	s w a ˈk r i j a
swarga	s w a r ɡ a
swasembada	s w a . s ə m . b a . d a
swasta	s w a s t a
swatantra	s ʋ a t a n t r a
syabas	ˈʃ a . b a s
syah	ʃ a h
syahadat	ʃ a ˈh a . d a t̚
syahbandar	ʃ a h . b a n . d a r
syahsiah	ʃ a h ˈs i a h
syak	ˈʃ a k̚
syal	ʃ a l
syamsi	ˈʃ a m s i
syarahan	ʃ a . ˈr a h . a n
syogun	ʃ o . ɡ u n
syogun	ʃ ɔ . ɡ u n
syukur	ˈʃ u k ʊ r
syukur	ʃ u ˈk ʊ r
syuriken	ʃ u . r i . k ɛ n
taaruf	t a a r u f
taat	ˈt a . ʔ a t̚
tabal	ˈt a . b a l
tabel	ˈt a b ə l
tabel	ˈt a b ɛ l
tabelaris	t a b ə l a r ɪ s
tabib	ˈt a b ɪ p̚
tablig	ˈt a b l ɪ k̚
tabu	ˈt a b u
tabungan	t a ˈb ʊ ŋ a n
tabur	ˈt a b ʊ r
taburan	t a . ˈb ʊ r . a n
tabut	ˈt a b ʊ t̚
tadah	ˈt a d a h
tadarus	t a d a r u s
tafeta	t a ˈf ɛ t a
tafsir	ˈt a f s ɪ r
tagih	ˈt a ɡ ɪ h
tahanan	t a ˈh a n a n
tahap	ˈt a . h a p
tahi	t a . h i
tahi	t a . i
tahkim	ˈt a h k ɪ m
tahu	ˈt a u
tahu	ˈt a . h u
tahun	ˈt a . h ʊ n
taiso	t a i . s o
Taiwan	ˈt a i̯ . w a n
tajin	t a . d͡ʒ ɪ n
taju	ˈt a d͡ʒ u
tak	t a k
takaful	t a ˈk a f ʊ l
takal	ˈt a . k a l
takar	ˈt a k a r
takeyari	t a . k e . y a . r i
takhta	t a x . t a
takikardia	t a . k i . ˈk a r . d i a̯
taklimat	t a ʔ ˈl i m a t̚
takoyaki	t a . k o . j a . k i
takoyaki	t a . k o . j a . k i
takraw	ˈt a k̚ . r a w
takraw	ˈt a k̚ . r a u̯
takrif	ˈt a ʔ r ɪ f
taksaka	t a k ˈs a k a
taksi	ˈt a k̚ s i
taksir	ˈt a k̚ s ɪ r
takut	t a . k u t
takwim	ˈt a k w ɪ m
talenta	t a . ˈl ɛ n . t a
tali	ˈt a l i
talian	t a ˈl i a n
tamadun	t a . ˈm a . d ʊ n
tamat	ˈt a m a t̚
tamatan	t a ˈm a t̚ a n
tambah	t a m b a h
tambur	ˈt a m b ʊ r
Tamil	ˈt a m ɪ l
tampar	t a m . p a r
tampil	t a m p i l
tampung	ˈt a m p ʊ ŋ
tamtama	t a m ˈt a m a
tanah	t a . n a h
tanam	ˈt a n a m
tanaman	t a n a m a n
tanda	ˈt a n d a
tandang	ˈt a n . d a ŋ
tanduk	t a n d u k
tangga	ˈt a ŋ ɡ a
tanggah	ˈt a ŋ ɡ a h
tanggalan	t a ŋ ˈɡ a l a n
tanggapan	t a ŋ . ɡ a . p a n
tangguh	ˈt a ŋ ɡ ʊ h
tangkap	ˈt a ŋ k a p̚
tangki	ˈt a ŋ . k i
tank	ˈt ɛ ŋ k
tank	ˈt a ŋ
tanpa	ˈt a n p a
tantangan	t a n ˈt a ŋ a n
tante	ˈt a n t ə
tanya	t a . ɲ a
tapa	t a . p a
tapa	t a . p a
tapa	t a . p a
tapa	t a . p a
tapak	ˈt a . p a k
tapas	ˈt a p a s
tapis	ˈt a . p ɪ s
tar	t a r
taraf	ˈt a . r a f
tarekat	t a ˈr ɛ k a t̚
target	ˈt a r ɡ ɛ t̚
taring	t a . r ɪ ŋ
tarkas	ˈt a r k a s
taruna	t a r u n a
tas	ˈt a s
tasbih	ˈt a s b ɪ h
tashih	ˈt a s . h ɪ h
tatap	t a . t a p̚
tato	ˈt a t o
tau	t a . ʊ
tau	t a ʊ
taufik	t a u f ɪ k
taun	ˈt a . ʊ n
tautan	t a ˈʊ t a n
tawakal	t a ˈw a k a l
tawan	ˈt a w a n
tawar	t a w a r
tawur	ˈt a w ʊ r
tayamum	t a ˈj a m ʊ m
tebang	t ə . ˈb a ŋ
tebusan	t ə . b u . s a n
teduh	t ə . ˈd ʊ h
tedung	t ə ˈd ʊ ŋ
tegak	t ə ˈɡ a k̚
tegap	t ə ˈɡ a p̚
tegar	t ə . ˈɡ a r
tegas	t ə ˈɡ a s
tegur	t ə ˈɡ ʊ r
teh	ˈt ɛ h
tekidanto	t ɛ . k i . d a n . t o
tekor	t ə . k o r
tekstur	ˈt ɛ k s t ʊ r
telaah	t ə . l a . ʔ a h
teladan	t ə l a d a n
telaga	t ə ˈl a . ɡ a
telah	t ə ˈl a h
telefon	t e ˈl e f ɔ n
telepon	t e ˈl e p ɔ n
telepon	t e ˈl e p o n
televisi	t e l e v i s i
telur	t ə ˈl u r
tembak	t e m b a k
tempat	t ə m p a t
tempel	ˈt ɛ m p ɛ l
tempeleng	t ə m . ˈp e . l ɛ ŋ
tempo	ˈt e m . p o
tempur	t ə m ˈp ʊ r
tempura	t ə m . p u . r a
temu	t ə ˈm u
tenang	t ə . n a ŋ
tengar	t ə ˈŋ a r
tenge	ˈt e ŋ e
tenggelam	t ə ŋ ɡ ə ˈl a m
tenggeret	t ə ŋ ˈɡ ɛ r ɛ t
tenggorok	t̪ ə ŋ . ˈɡ o . r o k̚
tenggorokan	t̪ ə ŋ . ˈɡ o . r o . k ä n
tengkujuh	t ə ŋ ˈk u d͡ʒ ʊ h
tengok	ˈt e . ŋ ɔ k
tensi	t ɛ n s i
tentang	t ə n t a ŋ
tentara	t ə n ˈt a r a
tentu	t ə n ˈt u
teokrasi	t e o ˈk r a s i
teokratis	t e o ˈk r a t ɪ s
teologi	t e o ˈl o ɡ i
teorema	t e o ˈr ɛ m a
teori	t e o r i
tepar	ˈt ɛ p a r
tepat	t ə . p a t
tepis	t ə . ˈp ɪ s
tepung	t ə p ʊ ŋ
ter	t ɛ r
teraniaya	t ə r a n i a j a
terasi	t ə ˈr a s i
terbang	t ə r . b a ŋ
terbesar	t ə r b ə ˈs a r
terbit	t ə r ˈb ɪ t̚
terburuk	t ə r ˈb u r ʊ k̚
terein	t ə ˈr e ɪ n
terima	t ə ˈr i m a
terintegrasi	t ə r ɪ n t ə ˈɡ r a s i
teriyaki	t ɛ . r i . j a . k i
terjelas	d͡ʒ ə ˈl a s
terjemahan	t ə r d͡ʒ ə ˈm a h a n
terkait	t ə r ˈk a ɪ t̚
terkenal	t ə r k ə n a l
terlalu	t ə r l a l u
termin	t ə r ˈm ɪ n
termoregulasi	t ɛ r . m o . r e . ɡ u . ˈl a . s i
terorisme	t e . r ɔ r . ˈɪ s . m ə
terowongan	t ə r o ˈw ɔ ŋ a n
terpal	t ə r ˈp a l
terpanjang	t ə r ˈp a n d͡ʒ a ŋ
terpidana	t ə r . p i . ˈd a . n a
tersebar	t ə r s ə ˈb a r
tersier	t ɛ r ˈs i ɛ r
tertempel	t ə r ˈt ɛ m p ɛ l
tertinggal	t ə r ˈt ɪ ŋ ɡ a l
terung	t ə . ˈr ʊ ŋ
terwelu	t ə r ˈw ɛ . l u
tidak	ˈt i . d a k
tidur	t i . d u r
tiga	ˈt̪ i . ɡ ä
timah	ˈt i m a h
timbal	ˈt ɪ m b a l
timbang	ˈt ɪ m . b a ŋ
timbangan	t ɪ m . ˈb a ŋ . a n
timbel	t i m b ə l
timbun	ˈt ɪ m b ʊ n
timpang	ˈt ɪ m . p a ŋ
timur	t i m ʊ r
tindakan	t ɪ n . d a . k a n
tindas	ˈt ɪ n d a s
tinggal	ˈt ɪ ŋ ɡ a l
tinggi	ˈt ɪ ŋ ɡ i
tinja	ˈt ɪ n d͡ʒ a
tinjau	t i n d͡ʒ a u̯
tinta	t i n . t a
tipu	t i . p u
tir	ˈt ɪ r
tiram	ˈt i r a m
tirani	t i . ˈr a . n i
tiri	ˈt i r i
tiris	ˈt i r i s
tirta	t i r . t a
titah	ˈt i . t a h
titik	ˈt i t ɪ k̚
titinada	t i . t i . ˈn a . d a
titrasi	t i ˈt r a s i
tobang	t o . b a ŋ
tobang	t o . b a ŋ
tobiko	t o . b i . k o
tofu	t o . f u
toge	t o ɡ e
toh	ˈt ɔ h
toilet	ˈt o i̯ . l ɛ t̚
toko	ˈt o . k o
toksik	ˈt ɔ k . s ɪ k
toksikologi	ˈt ɔ k . s i . k o . ˈl o . ɡ i
toksin	ˈt ɔ k . s ɪ n
toksisitas	t ɔ k . s i . ˈs i . t a s
tolol	ˈt ɔ l ɔ l
tonton	ˈt ɔ n . t ɔ n
torka	t o r . k a
torsi	t o r . s i
torsi	t ɔ r . s i
toto	t o t o
TPS	t e . ˈp e . ɛ s
transfigurasi	t r a n s f i ɡ u ˈr a s i
transformasi	t r a n s . f ɔ r . ˈm a . s i
transkripsi	t r a n ˈs k r ɪ p s i
transparan	t r a n s ˈp a r a n
transparansi	t r a n s p a ˈr a n s i
tren	ˈt r ɛ n
trombosit	t r ɔ m ˈb o s ɪ t̚
tromol	ˈt r o . m o l
tsunami	s u . n a . m i
tsunami	t s u . n a . m i
tsuru	ʃ u . r u
tua	t u . a
tuai	t u a i̯
tuas	t u a s
tuba	ˈt u b a
tubuh	ˈt u b ʊ h
tudung	ˈt u . d ʊ ŋ
tugas	t u . ɡ a s
tuhan	t u . h a n
tukang	ˈt u . k a ŋ
tukar	ˈt u k a r
tukul	ˈt u . k ʊ l
tumbuh	ˈt ʊ m b ʊ h
tumbuhan	t ʊ m ˈb ʊ h a n
tunang	ˈt u . n a ŋ
tunda	ˈt ʊ n d a
tunggal	ˈt ʊ ŋ ɡ a l
tungkas	t ʊ ŋ k a s
tungku	ˈt ʊ ŋ k u
tunjangan	t ʊ n ˈd͡ʒ a ŋ a n
tunjuk	t u n d͡ʒ ʊ ʔ
tuntut	t u n . t ʊ t
Turki	ˈt u r k i
turun	ˈt u . r ʊ n
turunan	t u ˈr u n a n
turus	ˈt u . r ʊ s
tustel	t u s . t ɛ l
tutorial	t u . t o . ˈr i . a l
tuwung	ˈt ʊ w ʊ ŋ
twit	ˈtʷ ɪ t̚
uang	ˈʊ a̯ ŋ
uap	ˈʊ a p̚
uban	ˈu . b a n
uber	u b ə r
ubin	ˈu b i n
ucul	u . t͡ʃ u l
udah	u . d a h
udon	u . d o n
uduk	ˈu . d ʊ k
ufuk	ˈu f ʊ k
ukir	ˈu . k ɪ r
ukuran	u ˈk ʊ r a n
ulah	ˈʊ l a h
ulam	ˈu . l a m
ulama	u . l a . m a
ulat	u . l a t
ulun	ˈu l u n
ulur	ˈu . l ʊ r
umat	ˈu m a t̚
umbi	ˈʊ m . b i
umbul	ˈʊ m . b ʊ l
umi	ˈʊ m i
umur	u m ʊ r
undangan	ʊ n . ˈd a ŋ . a n
unduh	ˈu n d u h
undur	u n ˈd ʊ ɾ
unggah	ˈu ŋ ɡ a h
unggul	u ŋ ɡ ʊ l
ungkep	ˈʊ ŋ k ə p̚
unik	ˈu n i k
unta	ˈʊ n t a
UP	ˈu p e
upah	ˈʊ p a h
upawasa	u p a . w a . s a
upaya	ˈʊ p a j a
urbanisasi	ʊ r b a n i ˈs a s i
urip	ˈu . r ɪ p̚
urita	u ˈr i t a
urut	ˈu r u t
usada	u . s a . d a
usada	u . s a . d a
usali	u ˈs a l i
usang	u s a ŋ
uskup	u s . k ʊ p
ustaz	ˈʊ s t a z
usul	ˈu s ʊ l
utama	ˈu t a m a
utan	u . t a n
utara	u t a r a
validitas	v a . l i . ˈd i . t a s
varietas	v a . r i . ˈe . t a s
vasodilatasi	v a s o d i l a ˈt a s i
vasokonstriksi	v a s o k ɔ n s ˈt r ɪ k s i
verano	v e ˈr a n o
verifikasi	v ɛ r i f i ˈk a s i
versi	ˈv ɛ r s i
veteriner	v ɛ . t ə . ˈr i . n ɛ r
vetsin	v ɛ t . ʃ i n
vetsin	v ɛ . t s i n
vibrasi	v i . ˈb r a . s i
videografer	v i d e o ˈɡ r a f ə r
virus	v i r u s
virus	v a j r ə s
visa	ˈv i s a
visum	ˈv i s ʊ m
visus	ˈv i s ʊ s
vokal	ˈv o . k a l
voli	ˈv o . l i
volume	v o ˈl u m ə
volume	p o ˈl u m ə
volunter	v o ˈl ʊ n t e r
voucer	ˈv o u̯ t͡ʃ ə r
vulkanis	v ʊ l ˈk a n ɪ s
vulkanologi	f u l k a n o ˈl o ɡ i
w	w
w	w ɛ
WA	w e . ʔ a
WA	w e a
wadah	ˈw a . d a h
waduh	w a d ʊ h
waduh	u a d ʊ h
waduk	ˈw a d ʊ k̚
wafat	ˈw a f a t̚
wagyu	w a . ɡʲ u
wahana	w a ˈh a n a
waja	ˈw a d͡ʒ a
wajah	ˈw a . d͡ʒ a h
wajib	ˈw a d͡ʒ ɪ p
waktu	w a k . t u
walau	ˈw a l a u̯
wali	w a l i
wana	w a . n a
wanara	w a . n a . r a
wanaternak	w a n a ˈt ə r n a k
wanda	ˈw a n . d a
wangsa	w a ŋ . s a
wanita	w a . n i . t a
wanprestasi	w a n p r e s t a s i
warak	ˈw a . r a k
waralaba	w a r a ˈl a b a
waria	ˈw a . r i . j a
warita	w a ˈr i t a
warkah	ˈw a r . k a h
warkat	ˈw a r . k a t
warsa	ˈw a r . s a
Waruna	w a . r u . n a
wasabi	w a ˈs a b i
wasana	w a ˈs a n a
wasbak	w a s b a k̚
waspada	w a s ˈp a d a
watak	ˈw a . t a ʔ
watan	w a . t a n
watas	ˈw a t a s
Wates	ˈw a t ə s
wayang	ˈw a . j a ŋ
wazari	w a . z a . r i
wazir	ˈw a z ɪ r
weker	w ɛ . k ə r
wenang	w ə . n a ŋ
wewenang	w ə . w ə . ˈn a ŋ
wibu	w i . b u
wicara	w i . t͡ʃ a . r a
widyaiswara	w i t j a i s ʋ a r a
wihara	w i . h a . r a
wilahar	w i ˈl a h a r
wilapa	w i l a p a
wilis	ˈw i . l ɪ s
wilis	w i l ɪ s
wira	ˈw i r a
wiruk	ˈw i r ʊ k
wizurai	w i ˈz u r a i̯
wol	ˈw o l
wol	ˈw ɔ l
woles	ˈw ɔ l ə s
wortel	w o r . t ə l
wreda	w r ə . d a
wudu	ˈw u . d u
wuku	ˈw u . k u
x	ɛ k s
y	j e
y	j
ya	j a
yakin	ˈj a k ɪ n
yakitori	j a . k i . t o . r i
yakni	ˈj a ʔ n i
yang	ˈj a ŋ
yen	j ɛ n
yen	j e n
yo	j oː
Yogyakarta	j o ɡ j a k a r t a
yubileum	j u b i ˈl e ʊ m
yudikatif	j u d i ˈk a t ɪ f
yudisial	j u d i ˈs i a l
yudisium	j u d i ˈs i ʊ m
yurisprudensi	j u r ɪ s p r u ˈd ɛ n s i
yuyitsu	j u . j i t . s u
z	z
z	s
zakar	ˈz a k a r
zakat	ˈz a k a t̚
zalim	ˈz a l ɪ m
zalir	ˈz a l i r
zat	ˈz a t̚
zen	z ɛ n
ziarah	z i ˈa r a h
zikir	ˈz i k ɪ r
zonasi	z o ˈn a s i
śāsana	s a . s a . n a
ᬰᬶᬯ	s i w a
ḍiri	a b o n ə m ɛ n
ꦔꦺꦴꦏꦺꦴ	ŋ ɔ k ɔ
ꦢꦺꦱ	d e . s ɔ
ꦥꦩꦺꦴꦁ	p a . m ɔ ŋ
ꦭꦸꦮꦏ꧀	l u . w a k
ꦱꦶꦠꦶ	s i . t i
ꦱꦺꦧ	s e b a
ꦱꦺꦮ	s e w a
ꦱꦺꦴꦕ	s o t͡ʃ ɔ
ꦱꦺꦴꦕ	s o t͡ʃ a
ꦲꦤ	ɔ n ɔ
ꦲꦤ	a n ə
ꦲꦤ	a n a
