معضون	m ʌː z uː n
کلچر	k ʌ l t͡ʃ ʌ r
جزیرہ	d͡ʒ ʌ z iː r ʌ
عیسائی	ʌ iː s aː iː
کیئر	k eː ʌ r
انکڈل	ʌ n k ʌ d l
رفت	r ʌ f t
استفسار	ʌ s t ʌ f s aː r
فرار	f ʌ r aː r
عنقریب	ʌ n q r iː b
نطرثانی	n ʌ t̪ r s aː n iː
کاٹ	k aː t̪
ساڑھے	s aː r ʌ
مشائخ	m ʌ ʃ aː ɪ x
واڑی	ʋ aː r iː
بےدخلی	b eː d ʌ x l iː
پھیلاؤ	pʰ eː l aː o
میدان	m eː d aː n
پسینہ	p ʌ s iː n ʌ
ٹسکرس	t̪ ʌ s k r ʌ s
پجرنا	p ʌ d͡ʒ r n aː
کیمپ	k eː m p
کوشاں	k oː ʃ aː n
مصارف	m ʌ s aː r ʌ f
اٹاپٹو	ʌ t̪ aː p t̪ o
ایرانڈیا	ʌ iː r aː n d̪ iː aː
رب	r ʌ b
جوفری	d͡ʒ o f r iː
ناساز	n aː s aː z
ڈھانک	ɖʱ aː n k
ندیم	n ʌ d iː m
کروڑ	k ʌ r oː r
ترنمول	t̪ ʌ r n m oː l
قوانین	q ʌ ʋ aː n iː n
قدر	q ʌ d r
موجودہ	m oː d͡ʒ oː d̪ ʌ
ٹم	t̪ ʌ m
نائٹ	n aː iː t̪
ابیان	ʌ b iː aː n
لکشمی	l ʌ k ʃ m iː
ہومگارڈ	ɦ oː m g aː r ɖ
مینار	m iː n aː r
شیوشنکر	ʃ iː o ʃ n k r
فوارے	f ʋ aː r eː
مولین	m oː l iː n
زاید	z aː iː d
کھیلنا	kʰ eː l n aː
اوقاف	oː q aː f
غیرمعروف	ɣ eː r m ʌ ʌ r oː f
کڑپہ	k ʌ r p ʌ

    نکما	n ɪ k m ɑː
    ٹھیک	ʈʰ iː k
    نسق	n ɪ s q
    بہنا	b ə ɦ n ɑː
    دیویندر	d eɪ ʋ iː n d ə ɾ
    شاستر	ʃ ɑː s t̪ ə ɾ
    قدرے	q ɪ d ɾ eɪ
    مسٹرسنہا	m ɪ s ʈ ə ɾ s n ə ɦ ɑː
    مکھ	m ʊ kʰ
    جاسوس	d͡ʒ ɑː s uː s
    ڈیفنس	ɖ iː f n ɪ s
    کپڑا	k ə p ɽ ɑː
    خلل	x ʊ l l
    ساتویں	s ɑː t̪ oʊ ʋ eɪ n
    ارسال	ɪ ɾ s ɑː l
    ناتھولا	n ɑː t̪ʰ oʊ l ɑː
    کائنات	k ɑː ɪ n ɑː t̪
    عمری	ʕ ʊ m r iː
    الھند	ʔ ə l ɦ ɪ n d̪
    خریدوانا	x ə r iː d̪ ʋ ɑː n ɑː
    انٹرملان	ɪ n ʈ ə ɾ m ə l ɑː n
    قابلیت	q ɑː b l iː t̪
    اسپانچ	ɪ s p ɑː n t͡ʃ
    سکو	s ə k oʊ
    جائلس	d͡ʒ ɑː ɪ l s
    بوائز	b oʊ ɑː ɪ z
    رامچندر	ɾ ɑː m t͡ʃ ʊ n d̪ ə ɾ
    نانگل	n ɑː n ɡ ə l
    پڑ	p ɽ
    العبیدی	ʔ ə l ʕ ə b eɪ d̪ iː
    آٹو	ɑː ʈ oʊ
    تندور	t̪ ə n d̪ uː ɾ
    عینی	ʕ eɪ n iː
    بینالاقوامی	b eɪ n ɑː l ɑː q ʋ ɑː m iː
    جنم	d͡ʒ ə n m
    الیکٹریسٹی	ʔ ə l ɪ k ʈ ə r iː s t̪ iː
    ماچٹ	m ɑː t͡ʃ ʈ
    بیمار	b eɪ m ɑː ɾ
    بنگالی	b ə n ɡ ɑː l iː
    مارکس	m ɑː ɾ k s
    ندیم	n ə d̪ iː m
    پولیت	p oʊ l iː t̪
    مشائخ	m ʊ ʃ ɑː ɪ x
    محمدو	m ʊ ɦ ə m ə d̪ ʋ oʊ
    ران	ɾ ɑː n
    گولی	ɡ oʊ l iː
    اومیش	oʊ m iː ʃ
    اٹارنی	ɪ ʈ ɑː ɾ n iː
    خودمحتار	x ʊ d̪ m ʊ ɦ t̪ ɑː ɾ
    پرگنا	p ə ɾ ɡ n ɑː
پورکر	p ʊː r k ə r
جینت	d͡ʒ iː n t̪
تیکھا	t̪ iː kʰ ɑː
العبیدی	ʔ ə l ʕ ə b eː d̪ iː
پانڈے	p ɑː n ɖ eː
باولی	b ɑː ʋ oː l iː
ڈھا	ɖʱ ɑː
آغوش	ɑː ɣ ʊ ʃ
نثار	n ə s ɑː r
انڈر	ɪ n ɖ ə r
گروداس	ɡ ə r uː d̪ ɑː s
سندر	s ə n d̪ ə r
کینیڈانژاد	k eː n iː d̪ ɑː n ʒ ɑː d̪
یوں	j ʊː n
شکایات	ʃ iː k ɑː j ɑː t̪
انشورنس	ɪ n ʃ ʊ r ə n s
بایزید	b ɑː j z iː d̪
تولہ	t̪ ʊː l ɑː
اورنمائش	ɔː r n ə m ɑː ɪ ʃ
سائبرٹاورس	s ɑː ɪ b ə r ʈ ɔː r s
ڈگیس	ɖ ɪ ɡ iː s
ہاشمی	ɦ ɑː ʃ m iː
لٹیرا	l ʈ iː r ɑː
تقلید	t̪ ə q l iː d̪
مصنوعات	m ʊ s n ʊː ʕ ɑː t̪
شاپر	ʃ ɑː p ə r
ایکشن	ɛː k ʃ ə n
پورہ	p ʊː r ɑː
پرتگیا	p ə r t̪ ɪ ɡ j ɑː
خواہشمند	x ʋ ɑː ɦ ɪ ʃ m ə n d̪
لکشمن	l ə k ʃ m ə n
احمد	ʔ ə ɦ m ə d̪
سیرت	s iː r ə t̪
نکتہ	n ə k t̪ ɑː
عارضی	ʕ ɑː r ɪ d̪ z iː
تعمیری	t̪ ʕ ə m iː r iː
گردن	ɡ ə r d̪ ə n
شین	ʃ iː n
گھڑی	ɡʱ ə ɽ iː
جنوری	d͡ʒ ə n ʊː r iː
نافذ	n ɑː f ɪ z
ناراض	n ɑː r ɑː z
حقیئقت	ɦ ə q iː q ə t̪
جھک	d͡ʒʱ ʊ k
میتو	m iː t̪ ʊ
آرزو	ɑː r z ʊ
عبدالحمید	ʕ ə b d̪ ə l ɦ ə m iː d̪
جہاز	d͡ʒ ə ɦ ɑː z
کیوں	k j ʊː n
کاپی	k ɑː p iː

    نافذ	n ɑː f ɪ z
    نمائندہ	n ʊ m ɑː ɪ n d̪ ə
    رکھا	ɾ ʊ kʰ ɑː
    کاپی	k ɑː p iː
    انجانا	ɪ n d͡ʒ ɑː n ɑː
    بارہا	b ɑː ɾ ɦ ɑː
    اسپیشلسٹ	ɪ s p iː ʃ ʊ l s ʊ t̪
    تخلیہ	t̪ ʊ x l iː ɦ ɑː
    نااہلیت	n ɑː ɑː ɦ l iː t̪
    ویرنمنٹ	ʋ iː ɾ n ʊ m ʊ n t̪
    انوکھا	ɪ n ʊ kʰ ɑː
    طرابلس	t̪ ɾ ɑː b ʊ l s
    افرادی	ɑː f ɾ ɑː d̪ iː
    نمائندگان	n ʊ m ɑː ɪ n d̪ ɡ ɑː n
    دھرتی	d̪ ʊ ɾ t̪ iː
    نالے	n ɑː l eː
    فضاء	f ɪ z ɑː
    برطانوی	b ɾ ɪ t̪ ɑː n ʋ iː
    نردوش	n ʊ ɾ d̪ ʊ ʃ
    درشی	d̪ ʊ ɾ ʃ iː
    ٹینڈرس	ʈ eː n d̪ ʊ ɾ s
    ریکارڈز	ɾ eː k ɑː ɾ d̪ z
    مہنگی	m ʊ ɦ n ɡ iː
    چدمبرم	t͡ʃ ʊ d̪ m b ʊ ɾ m
    اوباما	ɔː b ɑː m ɑː
    پرفتن	p ʊ ɾ f t̪ ʊ n
    تماشہ	t̪ ʊ m ɑː ʃ ɑː
    سائبان	s ɑː ɪ b ɑː n
    ایمباسیٹرس	ɪ m b ɑː s iː ʈ ʊ ɾ s
    میڑچل	m eː ɽ t͡ʃ ʊ l
    ٹرانسکو	ʈ ɾ ɑː n s k ʊ
    مشکور	m ʊ ʃ k ʊ ɾ
    طورپر	t̪ ʊ ɾ p ʊ ɾ
    دکن	d̪ ʊ k n
    مانکیا	m ɑː n k iː ɑː
    غلبہ	ɣ ʊ l b ɑː
    آشکارا	ɑː ʃ k ɑː ɾ ɑː
    فوجداری	f ʊ d͡ʒ d̪ ɑː ɾ iː
    زبردستی	z ʊ b ɾ d̪ ʊ s t̪ iː
    چیارٹیبل	t͡ʃ iː ɑː ɾ ʈ iː b ʊ l
    نوموہیون	n ʊ m ʊ ɦ iː ʊ n
    معمولی	m ʊ ʔ m ʊ l iː
    سہولت	s ʊ ɦ ʊ l t̪
    مجیب	m ʊ d͡ʒ iː b
    مقصدبراری	m ʊ q s ʊ d̪ b ɾ ɑː ɾ iː
    ریکارڈز	ɾ eː k ɑː ɾ d̪ z
    میٹروپولیٹن	m eː ʈ ɾ ʊ p ʊ l iː ʈ ʊ n
    باقاعدہ	b ɑː q ɑː ɪ d̪ ɑː
    پان	p ɑː n
    بموجب	b ʊ m ʊ d͡ʒ b
روٹس	r oː ʈ s
پرفل	p ə r f ə l
ڈابسن	ɖ ɑː b s ə n
فوری	f ɔː r iː
فعالیت	f ʕ ɑː l iː t̪
کشتی	k ə ʃ t̪ iː
سمکھ	s ə m kʰ
عادل	ʕ ɑː d ə l
اشکینازی	ə ʃ k iː n ɑː z iː
خداوندی	x ʊ d ɑː ʋ ə n d̪ iː
خودمحتار	x ʊ d m ʊ h t̪ ɑː r
اودھاؤ	ɑː ʋ d̪ʱ ɑː ʊ
امتحان	ʊ m t̪ ɪ ɦ ɑː n
نند	n ə n d̪
گزشتہ	ɡ ʊ z ʃ t̪ ɑː
سبقت	s ə b q ə t̪
ندیاں	n ə d̪ iː ɑː n
مکتوب	m ʊ k t̪ uː b
عنقریب	ʕ ɪ n q ə r iː b
چاہیئے	t͡ʃ ɑː ɦ iː ə
كا	k ɑː
کروڑ	k ə r oː ɽ
دخل	d̪ ə x ə l
دھمکا	d̪ʱ ʊ m k ɑː
واڑی	ʋ ɑː ɽ iː
بجٹ	b ə d͡ʒ ʈ
تعمیراتی	t̪ ʕ ə m iː r ɑː t̪ iː
ٹھکانا	ʈʰ ə k ɑː n ɑː
نافذ	n ɑː f ɪ z
محروسی	m ʊ ɦ r uː s iː
عناصر	ʕ ɪ n ɑː s ə r
سمترا	s ə m t̪ r ɑː
ڈھانک	ɖʱ ɑː n k
آیوکت	ɑː j oː k t̪
المقدس	ʔ ə l m ʊ q d̪ ə s
درگاہ	d̪ ə r ɡ ɑː ɦ
عیادت	ʕ iː ɑː d̪ ə t̪
شوارع	ʃ ʊ ɑː r ʕ
سوکھ	s ʊ kʰ
اجناس	ə d͡ʒ n ɑː s
توجہی	t̪ ʊ d͡ʒ ɦ iː
مہاراشٹر	m ə ɦ ɑː r ɑː ʃ ʈ ə r
ہسپانیہ	ɦ ə s p ɑː n iː ɑː
مترا	m ə t̪ r ɑː
اٹارنی	ɑː ʈ ɑː r n iː
مذکور	m ʊ z k ʊ r
پار	p ɑː r
نور	n ʊ r
اسکام	ə s k ɑː m
سینکڑہ	s eː n k ɽ ə ɦ
معصوم	m ʕ ʊː s uː m
کمائی	k ʊ m ɑː ɪ
لامتناہی	l ɑː m t̪ n ɑː ɦ iː
نظرانداز	n ʊ z ɾ ɑː n d̪ ɑː z
الیکٹریسٹی	ə l j ɛ k t̪ ɾ ɪ s t̪ iː
ایل	ɛː l
مچھلی	m ʊ t͡ʃʰ l iː
فلاحی	f l ɑː ɦ iː
جینت	d͡ʒ iː n t̪
ارش	ɑː ɾ ʃ
انڈیوگونزیلویس	ɪ n d̪ iː oː g oː n z iː l oː v iː s
الوداع	ə l v ɪ d̪ ɑː ɪ
جائزہ	d͡ʒ ɑː ɪ z ə
تمام۔تر	t̪ ʊ m ɑː m t̪ ɾ
الیکٹرولائٹ	ə l j ɛ k t̪ ɾ oː l ɑː ɪ t̪
پہن	p ɛː n
چوبیس	t͡ʃ oː b iː s
سترویں	s t̪ ɾ oː v eː n
بیورو	b j ʊ ɾ oː
انہوں	ɪ n ɦ oː n
گولمیز	g oː l m iː z
پار	p ɑː ɾ
مراکیش	m ɾ ɑː k ɛː ʃ
مدائن	m ʊ d̪ ɑː ɪ n
اجتماع	ɪ d͡ʒ t̪ ɪ m ɑː ɪ
دارالقضات	d̪ ɑː ɾ ʊ l q ʊ z ɑː t̪
خنجر	x ʊ n d͡ʒ ɾ
تحریر	t̪ ɛː ɾ iː ɾ
جبری	d͡ʒ ʊ b ɾ iː
گندھاری	g ʊ n d̪ ɦ ɑː ɾ iː
جسور	d͡ʒ ʊ s ʊː ɾ
گرکیرت	g ɾ k iː ɾ t̪
وارسا	v ɑː ɾ s ɑː
کاپی	k ɑː p iː
فولک	f oː l k
مفاہمانہ	m ʊ f ɑː ɦ m ɑː n ɑː
جاسوس	d͡ʒ ɑː s uː s
زنانی	z ʊ n ɑː n iː
پرستش	p ɾ ʊ s t̪ ɪ ʃ
مشکور	m ʊ ʃ k ʊː ɾ
مہاراشٹر	m ɛː ɾ ɑː ʃ t̪ ɾ
انظر	ɪ n z ɾ
ایشیائی	ɛː ʃ iː ɑː ɪ
ریکٹر	ɾ eː k t̪ ɾ
آگ	ɑː g
تحفظ	t̪ ɛː f z
بات	b ɑː t̪
انہ	ɪ n ɦ
یورانیم	j ʊ ɾ ɑː n iː m
شیطان	ʃ eː t̪ ɑː n
روا	r ɔː ɑː
یونیسیف	j uː n iː s iː f
مکتوب	m ʊ k t̪ uː b
طلبی	t̪ ɑː l ɪ b iː
خسر	x ʊ s ɾ
چیرمین	t͡ʃ eː r m iː n
وینکٹ	ʋ eː n k ʈ
نورین	n ʊ r iː n
خاطیوں	x ɑː t̪ iː j oː n
شلپا	ʃ ʊ l p ɑː
پوزم	p oː z m
دلیری	d ə l iː r iː
وسیع	ʋ ʊ s iː ʕ
بلز	b ə l z
گمبھیر	ɡ ʊ m bʱ iː r
کرکٹرس	k ə r k ʈ ə r s
نیم	n iː m
الجھن	ʔ ə l d͡ʒ ʱ ʊ n
کھڑا	kʰ ə ɽ ɑː
آغوش	ɑː ɣ ʊ ʃ
ڈھانک	ɖʱ ɑː n k
مزدور	m ʊ z d̪ ʊ r
نکاح	n ɪ k ɑː ɦ
عنصر	ʕ ʊ n s ʊ r
کنٹیشور	k ʊ n ʈ iː ʃ ʊ r
سرمایہ	s ə r m ɑː j ə
الزہرہ	ʔ ə l z ə ɦ r ə
باہری	b ɑː ɦ ɪ r iː
ٹورسٹ	ʈ ɔː r s ʈ
اداشدہ	ʔ ə d̪ ɑː ʃ ʊ d̪ ə
نہا	n ə ɦ ɑː
ظفر	z ʊ f ə r
آئندہ	ɑː ɪ n d̪ ə
اسٹائسٹکس	ʔ ɪ s ʈ ɑː ɪ s ʈ ɪ k s
بودھن	b ʊ d̪ʱ n
بندر	b ʊ n d̪ ə r
راہ	r ɑː ɦ
سواری	s ʊ ɑː r iː
شاداب	ʃ ɑː d̪ ɑː b
دوچار	d̪ ʊ t͡ʃ ɑː r
انٹرنیشنل	ɪ n ʈ ə r n eː ʃ ʊ n ə l
پیڑ	p eː ɽ
پرہیزگاری	p ə r ɦ eː z ɡ ɑː r iː
ٹرافک	ʈ r ɑː f ɪ k
درسگاہ	d̪ ə r s ɡ ɑː ɦ
مضحکہ	m ʊ z ɦ ɑː k ə
جیل	d͡ʒ eː l
اڈمیرل	ʔ ə d̪ m iː r ə l
ناراض	n ɑː r ɑː z
سی	s iː
ساریامی	s ɑː r iː ɑː m iː
فتنہ	f ʊ t̪ n ə
معلوم	m ʌː l uː m
گردی	ɡ ʊ r d̪ iː
ابھشیک	ʌ bʱ ʃ iː k
شریک	ʃ ʌ r iː k
بنجر	b ʌ n d͡ʒ ʌ r
مجیب	m ʌ d͡ʒ iː b
جھگڑا	d͡ʒʱ ʌ ɡ ʌ r ɑː
پٹے	p ʌ ʈ eː
تعاونی	t̪ ʌː ʌ uː n iː
ادعا	ʌ d ʌː
گارنر	ɡ ɑː r n ʌ r
تلقین	t̪ ʌ l q iː n
مکر	m ʌ k ʌ r
بادبانی	b ɑː d̪ b ɑː n iː
چنی	t͡ʃ ʌ n iː
اندھیرا	ʌ n d̪ʱ iː r ɑː
سنت	s ʌ n t̪
گنجان	ɡ ʌ n d͡ʒ ɑː n
دیکشت	d iː k ʃ t̪
ٹائلٹ	ʈ ɑː ɪ l ʈ
توبہ	t̪ uː b ɑː
چیرمین	t͡ʃ eː r m iː n
باولی	b ɑː ʋ ʌ l iː
ایٹا	ɛː ʈ ɑː
سلجوقی	s ʌ l d͡ʒ ʌ uː q iː
ڈاک	ɖ ɑː k
ریشی	r eː ʃ iː
جدیدترین	d͡ʒ ʌ d iː d̪ t̪ ʌ r iː n
فرنانڈو	f ʌ r n ɑː n ɖ ʌ uː
دکھانا	d̪ ʌ kʱ ɑː n ɑː
مستحکم	m ʊ s t̪ ʌ ɦ k ʌ m
یونیورسٹی	j uː n iː ʋ ʌ r s ʈ iː
جگر	d͡ʒ ʌ ɡ ʌ r
جنیشور	d͡ʒ ʌ n iː ʃ ʌ r
مئی	m eː
عمر	ʌ m r
مشروب	m ʌ ʃ r uː b
دامودر	d ɑː m uː d̪ ʌ r
کامرس	k ɑː m r ʌ s
پذیرائی	p ʌ z iː r ɑː iː
اڑھا	ʌ ɽʱ ɑː
بجٹ	b ʌ d͡ʒ ʈ
انتہا	ʌ n t̪ ʌ ɑː
استثنی	ʌ s t̪ ʌ s n iː
ایہود	ɛː j ʌ ɦ uː d̪
سرم	s ʌ r m
انڈیوگونزیلویس	ʌ n ɖ iː ʋ ʌ ɡ ʌ n z iː l ʌ ʋ iː s
ولائتی	ʋ ʌ l ɑː ɪ t̪ iː

    اطالیہ	ɪ t̪ ɑː l iː ɑː
    بھکتی	bʱ ʊ k t̪ iː
    نسبت	n ə s b ə t̪
    کوتا	k oː t̪ ɑː
    کریم	k ə r iː m
    ختم	x ə t̪ m
    ایڈس	ɛː d̪ s
    کسی	k ə s iː
    کالسانگرا	k ɑː l s ɑː ŋ g r ɑː
    عام	ɑː m
    یونیسیف	j uː n iː s iː f
    دھرنہ	d̪ʱ ə r n ə
    گارڈیولا	ɡ ɑː r d̪ iː oː l ɑː
    دفنانا	d̪ ə f n ɑː n ɑː
    ڈوجی	ɖ oː d͡ʒ iː
    اطباء	ɪ t̪ ɪ b ɑː
    فلاحی	f l ɑː h iː
    میٹرس	m eː t̪ ə r s
    مجھ	m ʊ d͡ʒʱ
    سہل	s ə h l
    روزی	r oː z iː
    پریسیڈنٹ	p ə r eː s iː d̪ ə n t̪
    ثقافت	s ɪ q ɑː f t̪
    ٹرانسکو	ʈ r ɑː n s k oː
    ذلیل	z ə l iː l
    کولکاتا	k oː l k ɑː t̪ ɑː
    منصور	m ʊ n s ʊː r
    ران	r ɑː n
    ہائی۔ٹیکس	ɦ ɑː iː ʈ iː k s
    گھیرنے	ɡʱ iː r n eː
    وانچو	ʋ ɑː n t͡ʃ oː
    كا	k ɑː
    کومٹ	k oː m ʈ
    مول	m oː l
    باون	b ɑː ʋ n
    برسلز	b ə r s ə l z
    ڈسٹرکٹ	ɖ ɪ s ʈ r ɪ k ʈ
    صدرجمہوریہ	s ɪ d̪ r d͡ʒ ʊ m ɦ ʊː r iː ɑː
    نکاراتمک	n ɪ k ɑː r ɑː t̪ m ɪ k
    ادعاء	ɪ d̪ ʕ ɑː
    پھلکی	pʰ ʊ l k iː
    دھاندلی	d̪ʱ ɑː n d̪ l iː
    ہلاکت	ɦ l ɑː k t̪
    مالک	m ɑː l ɪ k
    بھگدڑ	bʱ ʊ g d̪ ɽ
    اسکولس	ə s k uː l s
    شائنی	ʃ ɑː iː n iː
    صلاح	s ɪ l ɑː ɦ
    مہلوک	m ə h l oː k
    کیابس	k iː ɑː b s
میز	m iː z
بہیرہ	b ɛː r ɛː
ذلیل	z ə l iː l
بات	b aː t̪
رخ	ɾ ʊ x
بوزخشان	b oː z x ʃ aː n
اڈے	ɑː ɖ eː
ابودرداء	ɑː b uː d ɾ ɪ d ɑː
بےصبری	b eː s ʊ b ɾ iː
گردن	ɡ ʊ r d ə n
دلچسپی	d ɪ l t͡ʃ ʊ s p iː
الفاظ	ʌ l f ɑː z
فائر	f aː ɪ ɾ
کیابس	k iː ɑː b s
کرکٹرس	k ɪ r k ɪ t̪ ɾ ʊ s
پالیسی	p aː l iː s iː
ریکارڈز	ɾ eː k ɑː ɾ d̪ z
فریقی	f ɪ r iː q iː
جارجیا	d͡ʒ aː r d͡ʒ iː ɑː
مجسٹریل	m ʊ d͡ʒ s t̪ ɪ r iː l
غیرضروری	ɣ ɛː r z ɪ r uː r iː
مسوری	m ʊ s uː r iː
پولیت	p oː l iː t̪
داستان	d aː s t̪ aː n
اکابر	ɑː k aː b ɪ r
انشورنس	ɪ n ʃ ʊ r ə n s
پسماندگی	p ʊ s m aː n d̪ ɡ iː
طاقتور	t̪ aː q t̪ ʊ ɾ
چیتاپور	t͡ʃ iː t̪ aː p ʊ r
شب	ʃ ʌ b
لرزہ	l ɪ r z ə
نثار	n ɪ s aː r
پڑوسی	p ɑː r oː s iː
پیلاگو	p eː l aː ɡ oː
کوششں	k oː ʃ ɪ ʃ ʌ n
چناب	t͡ʃ ʊ n aː b
اجتماع	ɪ d͡ʒ t̪ ɪ m aː ʕ
متوازن	m ʊ t̪ ʋ aː z ə n
بےپناہ	b eː p n aː ɦ
ولاقو	ʋ ə l aː q oː
الشیخ	ʌ l ʃ eː x
سلامی	s ə l aː m iː
ری۔ایکٹرس	ɾ eː ɑː ɪ k t̪ ɾ ʊ s
آٹھواں	ɑː t̪ʰ ʋ aː n
عمری	ʕ ʊ m r iː
قدوائی	q ʊ d̪ ʋ aː ɪ
بھنڈاری	bʱ ʊ n d̪ aː r iː
پریشد	p ɪ r eː ʃ d̪
مثلا	m ɪ s l aː
کارنامہ	k aː r n aː m ə

    کوشاں	k ʊ ʃ ɑː n
    فلورنگ	f l ɔː r n ɪ ŋ
    ادب	ɑː d̪ b
    سلم	s ʊ l m
    رنز	r ʊ n z
    ارادہ	ɑː r ɑː d̪ ɑː
    سنور	s ʊ n ɔː r
    حریت	ħ ʊ r iː t̪
    ٹورنمنٹ	ʈ ɔː r n ʊ m ʊ n ʈ
    بہیرہ	b ɛː r ɑː
    قلم	q ʊ l ʊ m
    عمرہ	ʕ ʊ m r ɑː
    ہائی۔ٹیکس	ɦ ɑː iː ʈ iː k s
    کیوں	k j ɔː n
    ماچٹ	m ɑː t͡ʃ ʈ
    خسرہ	x ʊ s r ɑː
    برڈ	b ʊ r ɖ
    گذرنا	ɡ ʊ z r ʊ n ɑː
    ترپاٹھی	t̪ ʊ r p ɑː ʈʰ iː
    مینا	m eː n ɑː
    عجائبات	ʕ ʊ d͡ʒ ɑː ɪ b ɑː t̪
    کلچر	k ʊ l t͡ʃ ʊ r
    چھاونی	t͡ʃʰ ɑː ʋ n iː
    ڈگ	ɖ ʊ ɡ
    بہنا	b ɛː n ɑː
    موعود	m ʊ ʕ ʊː d̪
    سننا	s ʊ n n ɑː
    مجرمانہ	m ʊ d͡ʒ r ɪ m ɑː n ɑː
    شرائط	ʃ ʊ r ɑː ɪ ʈ
    چلا	t͡ʃ ʊ l ɑː
    مکرم	m ʊ k r ʊ m
    احمدآباد	ɑː ħ m ʊ d̪ ɑː b ɑː d̪
    صالح	s ɑː l ɛː ħ
    حرج	ħ ʊ r d͡ʒ
    اکائی	ɑː k ɑː iː
    تشکیل	t̪ ʊ ʃ k iː l
    گڑیا	ɡ ʊ ɽ iː ɑː
    اجمیر	ɑː d͡ʒ m iː r
    راج	r ɑː d͡ʒ
    گنجان	ɡ ʊ n d͡ʒ ɑː n
    کیپرس	k eː p r ʊ s
    اساس	ɑː s ɑː s
    ٹسکالوسکا	ʈ s k ɑː l ʊ s k ɑː
    ممنوعہ	m ʊ m n ʊ ʕ ɑː
    پردیب	p ʊ r d̪ iː b
    تحریر	t̪ ʊ ħ r iː r
    بھال	bʱ ɑː l
    بنجر	b ʊ n d͡ʒ ʊ r
    بچھڑی	b ʊ t͡ʃʰ ɽ iː
    معلم	m ʊ ʕ l ʊ m

    راج	r ɑː d͡ʒ
    کراہیت	k ɾ ɑː ɦ iː t̪
    پھاڑ	pʰ ɑː ɽ
    پڑھ	p ɽʱ
    اسٹیونس	ɪ s ʈ iː oː n s
    تدریسی	t̪ ə d̪ ɾ iː s iː
    ابلیس	ə b l iː s
    کتراپی	k ʊ t̪ ɾ ɑː p iː
    لاشعوری	l ɑː ʃ eː ʋ oː ɾ iː
    قیام	q iː ɑː m
    عمرہ	ʕ ʊ m ɾ ə
    کس	k ʊ s
    ٹریژری	ʈ ɾ iː ʒ ə ɾ iː
    کاپوریشن	k ɑː p oː ɾ iː ʃ ə n
    سکو	s ə k oː
    ہمسفر	ɦ ʊ m s ə f ə ɾ
    آگاہی	ɑː ɡ ɑː ɦ iː
    دلجمعی	d ə l d͡ʒ ʊ m ʕ iː
    سکریٹری	s ə k ɾ iː ʈ ə ɾ iː
    گوناگوں	ɡ oː n ɑː ɡ oː n
    لاٹھی	l ɑː ʈʰ iː
    روا	ɾ ʋ ɑː
    لہجہ	l ə ɦ d͡ʒ ə
    شیشے	ʃ iː ʃ eː
    معتمد	m ʊ ʕ t̪ ə m ɪ d̪
    ابتر	ə b t̪ ə ɾ
    گلاس	ɡ l ɑː s
    موعود	m oː ʕ uː d̪
    چھونا	t͡ʃʰ oː n ɑː
    ایمان	ɑː iː m ɑː n
    سہل	s ə ɦ l
    کیتیش	k iː t̪ iː ʃ
    خط	x ʌ t̪
    سوان	s ʋ ɑː n
    عبد	ʕ ə b d̪
    زیر۔قیادت	z iː ɾ q iː ɑː d̪ ə t̪
    مکھو	m ʊ kʰ oː
    ٹیکسی	ʈ iː k s iː
    چیلنج	t͡ʃ eː l ə n d͡ʒ
    روپیا	ɾ uː p iː ɑː
    نان	n ɑː n
    میڑچل	m eː ɽ t͡ʃ ə l
    تدبیر	t̪ ə d̪ b iː ɾ
    کالنگ	k ɑː l ə ŋ ɡ
    اوقافی	oː q ɑː f iː
    الاسد	ə l ɑː s d̪
    کیوبا	k iː oː b ɑː
    مکتب	m ʊ k t̪ ə b
    یوم	j oː m
    آمیز	ɑː m iː z

    ظہیرآباد	z ə ɦ iː r ɑː b ɑː d
    زبیر	z ʊ b eː r
    میڑچل	m eː ɽ t͡ʃ ə l
    امکانی	ʊ m k ɑː n iː
    واجبی	ʋ ɑː d͡ʒ b iː
    بنچس	b ə n t͡ʃ ə s
    بھرت	bʱ ə r t̪
    فکسنگ	f ə k s ɪ ŋ
    عقبہ	ʕ ʊ q b ə
    فوری	f ɔː r iː
    روگردانی	r ɔː ɡ ə r d̪ ɑː n iː
    کمل	k ʊ m ə l
    کسمپرسی	k ə s m ʊ p r ə s iː
    ولائتی	ʋ ɪ l ɑː ɪ t̪ iː
    پوچیا	p ɔː t͡ʃ iː ɑː
    انار	ɑː n ɑː r
    روٹس	r ɔː ʈ s
    جارجن	d͡ʒ ɑː r d͡ʒ ə n
    طیرانگاہ	t̪ ɪ ɾ ɑː n ɡ ɑː ɦ
    زائد	z ɑː ɪ d̪
    مردانہ	m ə r d̪ ɑː n ə
    سہواس	s ə ɦ ʋ ɑː s
    کمپ	k ʊ m p
    سائنسداں	s ɑː ɪ n s d̪ ɑː n
    اسٹیم	ɪ s ʈ iː m
    چھاڑ	t͡ʃʰ ɑː ɽ
    شجرکاری	ʃ ə d͡ʒ r k ɑː r iː
    آئیرن	ɑː ɪ ə r n
    ڈال	ɖ ɑː l
    اینٹورپن	ɑː ɪ n ʈ ɔː r p ə n
    گنگولی	ɡ ʊ ŋ ɡ ɔː l iː
    نسچل	n ə s t͡ʃ ə l
    نکل	n ɪ k ə l
    اگزامنیشن	ʌ ɡ z ɑː m n ɪ ʃ ə n
    تئن	t̪ ɛː n
    مینا	m eː n ɑː
    بدھا	b ʊ d̪ʱ ɑː
    فرق	f ə r q
    تئیں	t̪ ɛː ɪ n
    اسکینڈلس	ɪ s k iː n ɖ ə l s
    ناقد	n ɑː q ɪ d̪
    خطا	x ʌ t̪ ɑː
    رات	r ɑː t̪
    ہنوز	ɦ ə n ɔː z
    انعام	ɪ n ʕ ɑː m
    کیمیا	k eː m iː ɑː
    قدرے	q ɪ d̪ r eː
    ہنس	ɦ ə n s
    کنٹرےکٹ	k ə n ʈ r eː k ʈ
    اسوسی	ɪ s ʊ s iː

    آرڈر	ɑː r ɖ ə r
    تعزیتی	t̪ ə ʑ iː t̪ iː
    پ	p
    بیٹے	b eː ʈ eː
    میاں	m j ɑː n
    آکسیجن	ɑː k s iː d͡ʒ ə n
    کرےگی	k ə r eː ɡ iː
    سراب	s ə r ɑː b
    چاٹنا	t͡ʃ ɑː ʈ n ɑː
    ازاں	ə z ɑː n
    خاصے	x ɑː s eː
    مہاجرت	m ə h ɑː d͡ʒ ə r t̪
    گین	ɡ eː n
    رومس	r uː m s
    پراڈکٹس	p r ɑː ɖ ə k t̪ s
    ایڈس	eː ɖ s
    پری	p ə r iː
    اسپائس	ə s p ɑː iː s
    مینٹن	m eː n ʈ n
    دال	d ɑː l
    جاؤں	d͡ʒ ɑː ʊ n
    لہجہ	l ə ɦ d͡ʒ ə
    نزول	n ə z uː l
    وزیرداخلہ	ʋ ə z iː r d̪ ɑː x l ə
    بدعنوانی	b ə d̪ ʌ n ʋ ɑː n iː
    کیف	k eː f
    خراج	x ə r ɑː d͡ʒ
    ارسال	ə r s ɑː l
    انفورسمنٹ	ɪ n f ɔː r s m ə n ʈ
    ٹیکس	ʈ iː k s
    چھاڑ	t͡ʃʰ ɑː ɽ
    اکثر	ə k s ə r
    معاملت	m ʊ ɑː m l ə t̪
    باشاہ	b ɑː ʃ ɑː ɦ
    بےحیائی	b eː ɦ j ɑː iː
    سرشت	s ə r ʃ t̪
    ڈپٹی	ɖ ə p ʈ iː
    سٹی	s ʈ iː
    عیسیٰ	ʕ iː s ɑː
    مارکٹس	m ɑː r k ɪ t̪ s
    امکانی	ə m k ɑː n iː
    ڈگ	ɖ ə ɡ
    انتقال	ɪ n t̪ ɪ q ɑː l
    ثقافت	θ ə q ɑː f t̪
    طاقت	ʈ ɑː q ə t̪
    پرگنا	p ə r ɡ n ɑː
    قباحت	q ə b ɑː ɦ ə t̪
    سائینس	s ɑː iː n s
    کشور	k ə ʃ ʊ r
    قدرت	q ə d̪ r ə t̪
باولی	b aː oː l iː
کامتھ	k ɑː m t̪ʰ
گنگ	ɡ ʊ ŋ ɡ
لکژری	l ʌ k ʒ ɛ r iː
جبرئیل	d͡ʒ ɪ b r aɪ l
علما	ʕ ʊ l m ɑː
کیپرس	k eɪ p ɛ r s
رات	r ɑː t̪
مادری	m ɑː d ɛ r iː
کنسلٹنگ	k ʌ n s ʌ l t̪ ɪ ŋ ɡ
موہن	m oː ɦ ɛ n
حمیدالدین	ħ ʊ m iː d̪ ʌ l d̪ iː n
ڈرون	ɖ r oː n
نذرانہ	n ɪ z r ɑː n ɑː
اسمبلی	ʌ s m b l iː
اشیاء	ʌ ʃ j ɑː ʔ ɑː
پردیب	p ʊ r d̪ iː b
بوتے	b oː t̪ eɪ
کوی۶	k oː ɪ ʌ 6
عرض	ʕ ʊ r z
سرسوتی	s ʊ r s w ʊ t̪ iː
شناخت	ʃ ʊ n ɑː x t̪
انڈر	ʌ n ɖ ɛ r
ون	v ʊ n
کواری	k w ɑː r iː
ساریامی	s ɑː r iː ɑː m iː
نثار	n ɪ s ɑː r
ش	ʃ
گین	ɡ eɪ n
پولیت	p oː l iː t̪
زیرقیادت	z iː r q j ɑː d̪ ʌ t̪
معالجہ	m ʌ ʕ ɑː l ɪ d͡ʒ ɑː
بےہوش	b eɪ ɦ oː ʃ
پیام	p j ɑː m
ویش	v eɪ ʃ
وینکٹ	v eɪ n k ʌ t̪
مرحومہ	m ʊ r ɦ ʊ m ɑː
معاہدہ	m ʌ ʕ ɑː ɦ ɪ d̪ ɑː
دیرینہ	d̪ eɪ r iː n ɑː
فیروزی	f eɪ r oː z iː
سختی	s ʌ x t̪ iː
بلین	b l iː n
دوچار	d̪ oː t͡ʃ ɑː r
کروڑپتی	k ɾ oː ɽ p ʌ t̪ iː
دوری	d̪ oː r iː
افسوسناک	ʌ f s oː s n ɑː k
استوار	ʌ s t̪ w ɑː r
جوڑا	d͡ʒ oː ɽ ɑː
ٹاکیوو	ʈ ɑː k j oː v
ایشیا	ɑː ɪ ʃ iː ɑː
بنچ	b ə n t͡ʃ
پرسکون	p ə ɾ s k uː n
جیل	d͡ʒ iː l
کھٹائی	kʰ ʈ aː iː
دیانتداری	d̪ iː ɑː n t̪ d̪ ɑː ɾ iː
آندھرا	ɑː n d̪ʱ ə ɾ ɑː
چناب	t͡ʃ ə n ɑː b
پتلا	p ə t̪ l ɑː
بہکا	b ə ɦ k ɑː
موجودہ	m oː d͡ʒ uː d̪ ə ɦ
اکٹھا	ə k ʈʰ ɑː
طلبی	t̪ ɑː l b iː
مکتوب	m ʊ k t̪ uː b
ڈپٹی	ɖ ə p ʈ iː
جائلس	d͡ʒ ɑː ɪ l s
نکسلائٹ	n ɪ k s l ɑː iː t̪
اودھاؤ	ɑː ʊ d̪ʱ ɑː ʊ
اکانٹس	ə k ɑː n ʈ s
خطا	x ə t̪ ɑː
بش	b ʊ ʃ
کاروائی	k ɑː ɾ oː ɑː iː
اخراجات	ɑː x ɾ ɑː d͡ʒ ɑː t̪
مدینہ	m ə d̪ iː n ə ɦ
عجائبات	ʕ ɪ d͡ʒ ɑː ɪ b ɑː t̪
بمقابلہ	b ə m q ɑː b l ə ɦ
پرگی	p ə ɾ ɡ iː
فارچو	f ɑː ɾ t͡ʃ oː
آنا	ɑː n ɑː
ٹسکرس	ʈ s k ə ɾ s
ثالث	s ɑː l ɪ s
ڈرین	ɖ ɾ iː n
سلنڈر	s ə l ə n ɖ ə ɾ
سپلی	s ə p l iː
ببھکشا	b ə bʱ ə k ʃ ɑː
لحاظ	l ɪ ɦ ɑː z
انکڈل	ɪ n k ə ɖ l
بینچ	b eː n t͡ʃ
آگ	ɑː ɡ
ہیڈکوارٹر	ɦ eː ɖ k oː ɑː ɾ ʈ ə ɾ
محسن	m ʊ ɦ s ə n
ہند	ɦ ɪ n d̪
اسرائیل	ɪ s ɾ ɑː ɪ l
پڈوچیری	p ə ɖ oː t͡ʃ iː ɾ iː
عروس	ʕ ʊ ɾ uː s
اسپنر	ɪ s p n ə ɾ
مقدار	m ʊ q d̪ ɑː ɾ
آرڈر	ɑː ɾ ɖ ə ɾ
کامرس	k ɑː m ə ɾ s
بالخصوص	b ɑː l x ʊ s uː s
ادب	ɑː d̪ ə b

    پردیب	p ə ɾ d̪ iː b
    تنازعہ	t̪ ə n ɑː z ʌ ɦ
    بامشقت	b ɑː m ʃ q ʌ t̪
    شعار	ʃ ʌ ɑː ɾ
    پولیو	p oː l iː oː
    فوارے	f ʋ ɑː ɾ eː
    راجستھان	ɾ ɑː d͡ʒ s t̪ʰ ɑː n
    ونڈے	ʋ ʊ n ʈ eː
    بھارت	bʱ ɑː ɾ ʌ t̪
    بالخصوص	b ɑː l x ʌ s ʊ s
    کوہیر	k oː ɦ iː ɾ
    ب	b
    شانی	ʃ ɑː n iː
    جوگی	d͡ʒ oː ɡ iː
    دیویندر	d̪ eː ʋ iː n d̪ ɾ
    سالومان	s ɑː l oː m ɑː n
    النکرت	ə l n ʊ k ɾ ʌ t̪
    جنسی	d͡ʒ ʊ n s iː
    وویک	ʋ oː ʋ iː k
    وین	ʋ eː n
    ککش	k ʊ k ʃ
    تمہارا	t̪ ʊ m ɦ ɑː ɾ ɑː
    بھگدڑ	bʱ ʊ ɡ d̪ ɽ
    عامہ	ʕ ɑː m ɦ
    قیصر	q ɪ s ɾ
    دریا	d̪ ɾ iː ɑː
    ٹرانسپورٹ	ʈ r ɑː n s p ɔː r ʈ
    سی	s iː
    وظیفدار	ʋ ʊ z iː f d̪ ɑː ɾ
    طاق	t̪ ɑː q
    گھرا	ɡʱ ɾ ɑː
    جھونکا	d͡ʒʱ uː n k ɑː
    وصولی	ʋ ʊ s uː l iː
    ایمبرسمنٹ	ɛ m b ɾ ɛ s m ɛ n ʈ
    بنگالی	b ʊ ŋ g ɑː l iː
    منان	m ʊ n ɑː n
    جمعہ	d͡ʒ ʊ m ʌ ɦ
    گیارنٹی	ɡ j ɑː r n ʈ iː
    خیر	x eː ɾ
    تنگ	t̪ ʊ ŋ ɡ
    روا	ɾ ʋ ɑː
    دہی	d̪ ɛ ɦ iː
    دیگر	d̪ eː ɡ ɾ
    پستہ	p ɛ s t̪ ɦ
    مینڈس	m eː n ʈ s
    جٹا	d͡ʒ ʌ ʈ ɑː
    ایکسپریس	ɛ k s p ɾ eː s
    گزشتہ	ɡ ʊ z ʃ t̪ ɦ
    ہیکہ	ɦ eː k ɦ
    فریقی	f ɾ eː q iː

    تعزیتی	t ə ʕ z iː t̪ iː
    لاٹھی	l ɑː ʈʰ iː
    عبد	ʕ ə b d̪
    شبہات	ʃ ə b ɦ ɑː t̪
    پینسل	p iː n s ə l
    سونا	s ʊ n ɑː
    گین	ɡ eː n
    ذمہداری	z ə m ɦ d̪ ɑː ɾ iː
    وجود	ʋ ə d͡ʒ uː d̪
    راس	ɾ ɑː s
    گود	ɡ uː d̪
    دینی	d̪ iː n iː
    مباین	m ʊ b ɑː j n
    لاپرواہی	l ɑː p ɾ ʋ ɑː ɦ iː
    خودمحتار	x ʊ d̪ m ʊ ɦ t̪ ɑː ɾ
    برچھیت	b ə ɾ t͡ʃʰ iː t̪
    انڈین	ɪ n ʈ iː n
    بہیرہ	b ə ɦ eː ɾ ɑː
    وہ	ʋ ɔː ɦ
    کمپیوٹر	k ʌ m p j uː ʈ ə ɾ
    اکٹھا	ə k ʈʰ ɑː
    العبیدی	ʔ ə l ʕ ə b eː d̪ iː
    فریقی	f ə ɾ iː q iː
    بعدازاں	b ʕ ʊ d̪ ɑː z ɑː n
    مہیندرا	m ə ɦ iː n d̪ ɾ ɑː
    اگان	ə ɡ ɑː n
    ساحلی	s ɑː ɦ l iː
    خارجہ	x ɑː ɾ d͡ʒ ə
    جانی	d͡ʒ ɑː n iː
    غنہ	ɣ ə n ɑː
    تھکا	t̪ʰ ə k ɑː
    سنتوش	s ʊ n t̪ ɔː ʃ
    پرسار	p ə ɾ s ɑː ɾ
    زبیر	z ʊ b eː ɾ
    ایموٹو	ɛː m oʊ ʈ oʊ
    مانکیا	m ɑː n k iː ɑː
    قیصر	q eː s ɾ
    ڈال	ɖ ɑː l
    لازم	l ɑː z m
    ڈیویژنل	ɖ iː ʋ iː ʒ n ə l
    وجیہ	ʋ ə d͡ʒ iː ɦ
    اذیت	ə z iː t̪
    کا	k ɑː
    دستی	d̪ ə s t̪ iː
    ڈاریوس	ɖ ɑː ɾ iː ʊ s
    القاعدہ	ʔ ə l q ɑː ʕ ɪ d̪ ɑː
    کوچ	k ʊ t͡ʃ
    نارائن	n ɑː ɾ ɑː ɪ n
    خوش	x ʊ ʃ
    ووٹ	ʋ ʊ ʈ

    وینکٹ	ʋ eː n k ʌ t̪
    مفاہمت	m ʊ f ɑː ɦ m ə t̪
    گولہ	ɡ oː l ɑː
    خصوص	x ʊ s uː s
    بابرہ	b ɑː b ɾ ɑː
    جاؤں	d͡ʒ ɑː ʊ̃
    برسر	b ɾ ʊ s ɾ
    چراغاں	t͡ʃ ɾ ɑː ɣ ɑː̃
    جمعہ	d͡ʒ ʊ m ʌ ɦ
    شان	ʃ ɑː n
    اسکواڈ	ə s k oː ɑː d̪
    العرفائ	ə l ʌ ɾ f ɑː ɪ
    ندیم	n ə d̪ iː m
    افتتاح	ə f t̪ t̪ ɑː ɦ
    چوکا	t͡ʃ oː k ɑː
    ڈال	ɖ ɑː l
    کونسل	k oː n s ə l
    پرکلا	p ɛ ɾ k l ɑː
    پاپیا	p ɑː p iː ɑː
    رازداری	ɾ ɑː z d̪ ɑː ɾ iː
    طالبا	t̪ ɑː l ɪ b ɑː
    آمیز	ɑː m iː z
    دریا	d̪ ə ɾ iː ɑː
    نکتہ	n ʊ k t̪ ɑː
    لائے	l ɑː ɪ ɛ
    محروم	m ə ɦ ɾ uː m
    کیوبا	k iː ʋ b ɑː
    کانفرنس	k ɑː n f ɾ ə n s
    سج	s ʊ d͡ʒ
    جینت	d͡ʒ iː n t̪
    غلام	ɣ ʊ l ɑː m
    کھڑی	kʰ ʌ ɽ iː
    جھنڈ	d͡ʒ ʱ ʊ n ɖ
    گیڈ	ɡ eː ɖ
    برادرنسبتی	b ɾ ɑː d̪ ɾ n ə s b t̪ iː
    کرس	k ɾ ʊ s
    سپریمو	s ʊ p ɾ iː m oː
    چاہیئے	t͡ʃ ɑː ɦ iː ɛ
    پٹرولیم	p ʌ t̪ ɾ oː l iː m
    جوہری	d͡ʒ oː ɦ ɾ iː
    کب	k ʌ b
    بنوکلب	b ə n oː k l ʌ b
    مارون	m ɑː ɾ oː n
    مصروف	m ʊ s ɾ oː f
    نادیہ	n ɑː d̪ iː ɑː
    چھوٹنا	t͡ʃʰ oː ʈ n ɑː
    اسٹیڈیم	ə s t̪ iː d̪ iː m
    سرزنش	s ɾ z n ɛ ʃ
    کیابس	k iː ɑː b s
    طاقتور	t̪ ɑː q t̪ ʋ ɔː ɾ
سونا	s uː n aː
تلبیہ	t ə l b iː ɦ
پذیرائی	p ə z iː r aː iː
یافتہ	j aː f t̪ ə ɦ
چوبیس	t͡ʃ oː b iː s
آگاہ	ɑː ɡ aː ɦ
شوٹنگ	ʃ oː ʈ n ɡ
تھم	t̪ ɦ ə m
شنید	ʃ n iː d̪
نمبیار	n ə m b j aː r
ایرلائینس	ɛː r l aː ɪ n s
سمیع	s ə m iː ʕ
بیاگ	b j aː ɡ
آرام	ɑː r aː m
یوگانڈا	j uː ɡ aː n ʈ aː
التواء	ʔ ə l t̪ w aː
میڑچل	m iː ɽ t͡ʃ ə l
موٹر	m oː ʈ ə r
پوٹےشیم	p oː ʈ eː ʃ iː m
شرط	ʃ ə r t̪
مفتاحی	m uː f t̪ aː ɦ iː
ہلڑ	ɦ ə l ɽ
پٹنہ	p ʈ n ə ɦ
واجبی	w aː d͡ʒ b iː
ادعاء	ʔ ə d̪ ʕ aː
حقوق	ɦ ə q uː q
یکجا	j ə k d͡ʒ aː
پیلاگو	p eː l aː ɡ oː
پرتبھا	p ə r t̪ b ɦ aː
چھڑا	t͡ʃʰ ɽ aː
الشمس	ʔ ə l ʃ ə m s
کیسی	k eː s iː
ذاکر	z ɑː k ə r
سیرسہ	s eː r s ə ɦ
یوہان	j uː ɦ aː n
نصرت	n ə s r ə t̪
گدھ	ɡ ə d̪ʱ
شہادت	ʃ ə ɦ aː d̪ ə t̪
نافذالعمل	n aː f iː z ʔ ə l ʕ ə m ə l
سج	s ə d͡ʒ
گفتگو	ɡ ʊ f t̪ ɡ oː
کفر	k ə f ə r
ایل	ɛː l
شاپر	ʃ aː p ə r
د	d
جٹ	d͡ʒ ʈ
چندناکھن	t͡ʃ ə n d̪ n aː kʰ n
راو	r aː ʋ
لوتھ	l oː t̪ʰ
ویٹرنری	w eː ʈ ə r n ə r iː
درگاہ	d ə r ɡ ɑː ɦ
پٹی	p ʈ iː
کیول	k eɪ ʋ ə l
بھارت	bʱ ɑː r ə t̪
ڈرونس	ɖ r oː n s
ایٹا	eɪ ʈ ɑː
سرم	s ə r m
سامنے	s ɑː m n eɪ
ہسپانیہ	ɦ ɪ s p ɑː n iː ɑː
کنٹرولرس	k ə n ʈ r oː l ə r s
شے۶	ʃ eɪ 6
تصویر	t̪ ə s ʋ iː r
عقبہ	ʕ ɪ q b ɑː
تحریک	t̪ ə ɦ r iː k
چیلنج	t͡ʃ eɪ l ə n d͡ʒ
انوکھا	ə n oː kʰ ɑː
ٹیوب	ʈ iː ʋ b
طالب	ʈ ɑː l ɪ b
آئٹمس	ɑː ɪ ʈ m s
موظف	m ʊ z ʊ f
ایرانی	eɪ r ɑː n iː
صحابہ	s ɪ ɦ ɑː b ɑː
مہمان	m eɪ m ɑː n
نسبت	n ɪ s b ə t̪
رہ	r ə ɦ
توصیف	t̪ ʊ s iː f
فورا	f ʊ r ɑː
کوئ	k ʊ ɪ
ابھیلاشا	ə bʱ iː l ɑː ʃ ɑː
گائناکالوجی	ɡ ɑː ɪ n ɑː k ɑː l oː d͡ʒ iː
پراڈکٹس	p r ɑː ɖ k ʈ s
شنتانو	ʃ ə n t̪ ɑː n uː
وینکٹ	ʋ eɪ n k ʈ
سیرت	s iː r ə t̪
کرےگی	k ə r eɪ ɡ iː
بلاکس	b l ɑː k s
اکسپریس	ə k s p eɪ r iː s
باولی	b ɑː ʋ l iː
انفرنس	ɪ n f ə r n s
تناظر	t̪ ə n ɑː z ə r
شہلا	ʃ ə ɦ l ɑː
کفایتی	k ə f ɑː ɪ t̪ iː
کونکنی	k ʊ n k n iː
بیزار	b eɪ z ɑː r
ساری	s ɑː r iː
الیکٹرولائٹ	ə l eɪ k ʈ r oː l ɑː ɪ ʈ
آخرت	ɑː x ə r ə t̪
زینت	z eɪ n ə t̪
جگر	d͡ʒ ə ɡ ə r
جواہر	d͡ʒ ʋ ɑː ɦ ə r
زیرقیادت	z ɪː r q iː ɑː d̪ t̪
قربت	q ʊ r b ə t̪
پسینہ	p ə s iː n ɑː
سرمئی	s ʊ r m eː iː
مہربند	m ə h r b ə n d̪
شہادت	ʃ ə h ɑː d̪ t̪
دفتری	d̪ ə f t̪ ə r iː
اناج	ɪ n ɑː d͡ʒ
فارمس	f ɑː r m s
دہندہ	d̪ ə h n d̪ ə h
قرعہ	q ʊ r ʕ ɑː
پیام	p j ɑː m
پجاری	p ʊ d͡ʒ ɑː r iː
پریدا	p ə r iː d̪ ɑː
متجاوز	m ʊ t̪ d͡ʒ ɑː ʋ ə z
لیاپس	l iː ɑː p s
پھیلی	pʰ eː l iː
نہس	n ə h s
میڈیم	m eː d̪ iː ə m
بدھسٹ	b ʊ d̪ʱ s ʈ
حافظ	ħ ɑː f ɪ z
عشرت	ʕ ɪ ʃ r ə t̪
مدیرا	m ʊ d̪ iː r ɑː
وبائی	ʋ ɔː b ɑː iː
آغوش	ɑː ɣ ʊ ʃ
رسالہ	r ɪ s ɑː l ɑː
بوائز	b ʋ ɑː iː z
غرض	ɣ ʊ r d̪ z
چتا	t͡ʃ ʊ t̪ ɑː
رنز	r ə n z
خارجہ	x ɑː r ɪ d͡ʒ ɑː
فٹچ	f ʈʃ
توسیعی	t̪ ʋ ʊ s iː ʕ iː
ضبط	z ʊ b t̪
برچھیت	b ə r t͡ʃʰ iː t̪
پینسل	p eː n s ə l
سائینس	s ɑː iː n s
آڈیٹنگ	ɑː ɖ iː t̪ ɪ ŋ
کرانیکل	k ə r ɑː n iː k ə l
پرگی	p ə r ɡ iː
سائبان	s ɑː iː b ɑː n
کوتا	k ʋ ʊ t̪ ɑː
مسوری	m ʊ s ʋ ʊ r iː
تحدید	t̪ ə h d̪ iː d̪
التواء	ʔ ə l t̪ ʋ ɑː
کوبائلوبہ	k ʋ ʊ b ɑː iː l ʋ ʊ b ɑː
سوا	s ʋ ɑː
چھاپا	t͡ʃʰ ɑː p ɑː
استثنی	ɪ s t̪ ɪ s n ɑː iː
محتاجی	m ʊ h t̪ ɑː d͡ʒ iː

    گہہ	ɡ ə ɦ ɦ
    مذاکراہ	m ʊ z ɑː k ɾ ɑː ɦ
    الیکشن	ə l iː k ʃ ə n
    روپوش	ɾ uː p oː ʃ
    دھو	d̪ʱ oː
    بنجارہ	b ə n d͡ʒ ɑː ɾ ɑː
    رائلس	ɾ ɑː ɪ l s
    مہاراشٹر	m ə ɦ ɑː ɾ ɑː ʃ ʈ ɾ
    یزدانی	j ɛ z d ɑː n iː
    چنتا	t͡ʃ ʊ n t̪ ɑː
    ایٹمی	ɛː ʈ m iː
    وجیہ	ʋ ə d͡ʒ iː ɦ
    تنگ	t̪ ə ŋ ɡ
    نارائن	n ɑː ɾ ɑː ɪ n
    بہت	b ə ɦ t̪
    کہنا	k ə ɦ n ɑː
    تماریڈی	t̪ ə m ɑː ɾ iː ɖ iː
    خاصا	x ɑː s ɑː
    انجنیئرنگ	ɪ n d͡ʒ ə n iː ə ɾ n ɡ
    انہ	ɪ n ɦ
    دینے	d̪ eː n ɛː
    حقارت	ɦ ʊ q ɑː ɾ ə t̪
    وشوکت	ʋ ə ʃ oː k ə t̪
    پسماندگی	p ə s m ɑː n d̪ ɡ iː
    کاری	k ɑː ɾ iː
    ذمہ۔دارانہ	z ə m ɦ ɖ ɑː ɾ ɑː n ɑː
    پیغام	p eː ɡ ɑː m
    جرثومہ	d͡ʒ ə ɾ s uː m ɑː
    سنور	s ə n ʊ ɾ
    رب	ɾ ə b
    شائد	ʃ ɑː ɪ d̪
    ورون	ʋ ə ɾ uː n
    پرزور	p ə ɾ z ʊ ɾ
    جائزہ	d͡ʒ ɑː ɪ z ɑː
    تصادم	t̪ ə s ɑː d̪ ə m
    بادبانی	b ɑː d̪ b ɑː n iː
    ٹرانسکو	ʈ ɾ ɑː n s k oː
    نامی	n ɑː m iː
    پینسل	p eː n s ə l
    موہنی	m oː ɦ n iː
    سلیکشن	s ə l iː k ʃ ə n
    لازم	l ɑː z ə m
    پجرنا	p ə d͡ʒ ɾ n ɑː
    لداخ	l ə d̪ ɑː x
    رنڈی	ɾ ə n ɖ iː
    آمدنی	ɑː m d̪ ə n iː
    شرم	ʃ ə ɾ m
    اوز	oː z
    ستاری	s t̪ ɑː ɾ iː
    فائدہ	f ɑː ɪ d̪ ə
موجودہ	m oː d͡ʒ uː d ɑː
حبشی	ħ ʊ b ʃ iː
کمیونٹی	k ə m j uː n ɪ t̪ iː
خلل	x ʊ l l
مشرق	m ɪ ʃ ɾ ɪ q
معصوم	m ʕ ʊ s uː m
ورون	ʋ ə ɾ uː n
تقریبا	t̪ ə q ɾ iː b ɑː
ٹکٹس	ʈ ɪ k ʈ s
مےئر	m eː ɪ ɾ
رومن	ɾ uː m ə n
سمجھ	s ʊ m d͡ʒ ɦ
د	d
چکرورتی	t͡ʃ ʊ k ɾ uː ɾ t̪ iː
کمپٹرولر	k ʊ m p ʊ ʈ ɾ oː l ə ɾ
کرس	k ɾ ʊ s
متاثرہ	m ʊ t̪ ɑː s ɪ ɾ ɑː
اسٹارس	ɪ s ʈ ɑː ɾ s
متقاضی	m ʊ t̪ q ɑː z iː
چلانا	t͡ʃ ə l ɑː n ɑː
سیرسہ	s eː ɾ s ə
بیمار	b iː m ɑː ɾ
کیتیش	k eː t̪ iː ʃ
گمبھیر	ɡ ʊ m bʱ iː ɾ
ہوڑا	ɦ ʊ ɽ ɑː
دستبردار	d ʊ s t̪ b ɾ d̪ ɑː ɾ
برڈ	b ɾ ʊ d̪
افراد۔سازی	ɑː f ɾ ɑː d̪ . s ɑː z iː
منان	m ə n ɑː n
فورٹ	f ɔː ɾ ʈ
کوششیں	k oː ʃ ɪ ʃ ẽː
پٹیل	p ʈ iː l
نتائج	n ə t̪ ɑː ɪ d͡ʒ
چوگنا	t͡ʃ oː ɡ n ɑː
ملازم	m ʊ l ɑː z ə m
اتم	ʊ t̪ ə m
بحسن	b ɦ ʊ s n
ابیان	ɑː b j ɑː n
اند	ɑː n d̪
فرق	f ɾ q
آغوش	ɑː ɣ oː ʃ
استثنی	ɪ s t̪ ɪ s n ɑː iː
صحافت	s ɪ ħ ɑː f ə t̪
کمپ	k ʊ m p
ڈگیس	ɖ ɪ ɡ iː s
رحمت	ɾ ɪ ħ m ə t̪
غیرمنافع	ɣ eː ɾ m ə n ɑː f ɪ ʕ
ابلیس	ɑː b l iː s
بچھڑی	b ɪ t͡ʃʰ ɽ iː
نہس	n ə ɦ s
بیدر	b iː d ə ɾ
شانی	ʃ ɑː n iː
نسبت	n ə s b ə t̪
فتنہ	f ə t̪ n ə
توقع	t̪ ʋ oː q ʕ
آسان	ɑː s ɑː n
احتراز	ə ɦ t̪ ɾ ɑː z
جمیعتہ	d͡ʒ ə m iː ʕ t̪ ə
دانیال	d ɑː n iː ɑː l
دل	d ə l
امدادی	ə m d ɑː d̪ iː
بجٹ	b ə d͡ʒ ʈ
متجاوز	m ə t̪ d͡ʒ ɑː ʋ ə z
شماری	ʃ ʊ m ɑː ɾ iː
مشرا	m ə ʃ ɾ ɑː
ہنوز	ɦ ə n oː z
وزیرستان	ʋ ə z iː ɾ s t̪ ɑː n
چارجس	t͡ʃ ɑː ɾ d͡ʒ ə s
ایرانی	ɛː ɾ ɑː n iː
لیول	l iː ʋ ə l
میزبان	m iː z b ɑː n
وینکٹیش	ʋ eː n k ʈ iː ʃ
عہدہ	ʕ ə ɦ d̪ ə
فرزند	f ə ɾ z ə n d̪
تعاقب	t̪ ʕ ɑː q ʊ b
امان	ə m ɑː n
ممتا	m ʊ m t̪ ɑː
سید	s eː d̪
کیابس	k iː ɑː b s
سنوار	s ə n ʋ ɑː ɾ
ساکری	s ɑː k ɾ iː
افتتاح	ə f t̪ t̪ ɑː ɦ
اذلان	ə z l ɑː n
خریدار	x ə ɾ iː d̪ ɑː ɾ
پوشیدہ	p oː ʃ iː d̪ ə
کالجس	k ɑː l d͡ʒ ə s
غیرمحفوظ	ɣ ɛː ɾ m ə ɦ f oː z
ناقد	n ɑː q ə d̪
شبانہ	ʃ ə b ɑː n ə
سمرتی	s ə m ɾ t̪ iː
مترا	m ə t̪ ɾ ɑː
ایت	ɛː t̪
ڈسمبر	ɖ ə s m b ə ɾ
مبشر	m ʊ b ʃ ɪ ɾ
جہدکار	d͡ʒ ə ɦ d̪ k ɑː ɾ
اڈوائزری	ə ɖ ʋ ɑː ɪ z ə ɾ iː
حجر	ɦ ə d͡ʒ ɾ
مجرمانہ	m ə d͡ʒ ɾ ɪ m ɑː n ə
لاما	l ɑː m ɑː
آلراؤنڈر	ɑː l ɾ ɑː ʊ n ɖ ə ɾ
سوہال	s uː h aː l
ململ	m ʊ l m ʊ l
جوڑ	d͡ʒ oː ɽ
کالم	k aː l ʊ m
سنور	s ʊ n oː ɾ
گودھرا	ɡ oː d̪ʱ ɾ aː
برچھیت	b ə ɾ t͡ʃʰ iː t̪
دعائے	d̪ʊ ɑː ɪ eː
قابلیت	q aː b l iː t̪
رامو	ɾ aː m oː
قاسمی	q aː s m iː
مینڈس	m eː n ɖ s
گلبرگہ	ɡ ʊ l b ə ɾ ɡ ə
بسس	b ə s s
سنوائی	s ʊ n oː ɑː iː
مضمون	m ʊ z m uː n
آنجہانی	ɑː n d͡ʒ ə h aː n iː
سوالیہ	s uː aː l iː ə
پریسیڈنٹ	p ɾ eː s iː ɖ ə n ʈ
شری	ʃ ɾ iː
شجر	ʃ ʊ d͡ʒ ɾ
شام	ʃ aː m
دہی	d̪ eː ɦ iː
میکسیکو	m eː k s iː k oː
انہوں	ɪ n ɦ oː n
شیشے	ʃ iː ʃ eː
سری	s ɾ iː
فرضی	f ɾ ə d̪ z iː
آبادی	ɑː b aː d̪ iː
علامہ	ʕ ə l aː m ə
وفاقی	ʋ ə f aː q iː
گولہ	ɡ oː l ə
تلبیہ	t̪ ə l b iː ə
غیرسرکاری	ɣ ɛː ɾ s ɾ k aː ɾ iː
پتلا	p ə t̪ l aː
ادعا	ʔ ə d̪ʱ ɑː
غمازی	ɣ ʊ m aː z iː
پوزم	p oː z m
بغیر	b ə ɣ ɛː ɾ
پرفل	p ə ɾ f l
مانند	m aː n ɪ n d̪
موہن	m oː ɦ n
خسرو	x ʊ s ɾ oː
عارضی	ʕ aː ɾ ə d̪ z iː
پارٹنر	p aː ɾ ʈ n ə ɾ
لیکچرر	l iː k t͡ʃ ə ɾ ɾ
سہواس	s ə h ʋ aː s
آیوکت	ɑː j oː k t̪
اندرا	ɪ n d̪ ɾ aː
دشواری	d̪ ʊ ʃ ʋ aː ɾ iː
ویراٹ	v ɪ r ɑː t̪
لیبرمن	l iː b ə r m ə n
عبدالحمید	ʕ b d̪ ʊ l ɦ ə m iː d̪
مسدود	m ʊ s d̪ uː d̪
لیئج	l iː ə d͡ʒ
سوتیلا	s ʊ t̪ iː l ɑː
سوز	s ʊ z
گفتگو	ɡ ʊ f t̪ ɡ oː
مضحکہ	m ʊ z ɦ ɑː k ə
باعزت	b ɑː ʕ ɪ z z ə t̪
پیٹرسن	p eː t̪ ə r s ə n
حسنی	ɦ ʊ s n iː
عارضی	ʕ ɑː r ɪ z iː
ترملگیری	t̪ ə r m ə l ɡ iː r iː
جانور	d͡ʒ ɑː n ʋ ə r
پھیلی	pʰ eː l iː
نومنتخب	n oː m ə n t̪ ɪ x ə b
میڑچل	m iː ɽ t͡ʃ ə l
سرپنچ	s ə r p ə n t͡ʃ
بھوگ	bʱ oː ɡ
سنوار	s ə n ʋ ɑː r
درسگاہ	d̪ ə r s ɡ ɑː ɦ
دل	d̪ ə l
بھنڈاری	bʱ ə n ɖ ɑː r iː
پٹریو	p ʈ r iː oː
بہنا	b ə ɦ n ɑː
مولوی	m oː l ʋ iː
مولانا	m oː l ɑː n ɑː
تھیلا	t̪ʰ iː l ɑː
باربروسہ	b ɑː r b ə r oː s ə
انشورنس	ɪ n ʃ ʊ r ə n s
بدلنا	b ə d̪ l n ɑː
قابلیت	q ɑː b l iː t̪
استوار	ɪ s t̪ ʋ ɑː r
انشاء	ɪ n ʃ ɑː ʔ
باقاعدگی	b ɑː q ɑː ʕ ɪ d̪ ɡ iː
غیرمعروف	ɣ ɛː r m ʕ ɾ ʊ f
تجارتی	t̪ ɪ d͡ʒ ɑː r t̪ iː
گارنر	ɡ ɑː r n ə r
تمہارا	t̪ ʊ m ɦ ɑː r ɑː
مڈبھیڑ	m ə ɖ bʱ iː ɽ
میکسیکو	m eː k s iː k oː
پارلیمنٹ	p ɑː r l iː m ə n ʈ
ٹیوٹ	ʈ iː ʊ ʈ
ڈسٹرکٹ	ɖ ɪ s ʈ r ɪ k ʈ
چشتی	t͡ʃ ɪ ʃ t̪ iː
وشاکھا	ʋ ʊ ʃ ɑː kʰ ɑː
بیدی	b eː d̪ iː
ایل	aɪ l
برسر	b ə r s ə r

    ٹورنمنٹ	ʈ ɔː r n ə m ə n ʈ
    کم	k ʌ m
    ولتھاٹی	ʋ ʊ l t̪ʰ ɑː ʈ iː
    دیانتداری	d̪ eː ɑː n t̪ d̪ ɑː r iː
    اسپیشلسٹ	ɪ s p eː ʃ l ɪ s ʈ
    برتن	b ə r t̪ ə n
    البتہ	ʌ l b ə t̪ ɑː
    نقلی	n ə q l iː
    شبانہ	ʃ ə b ɑː n ɑː
    سنا	s ʊ n ɑː
    سبقت	s ʊ b q ʊ t̪
    دور	d̪ ʊː r
    ریکارڈکردہ	r eː k ɑː r ʈ k ə r d̪ ɑː
    ایف	eː f
    ایشین	eː ʃ iː n
    آرٹیکل	ɑː r ʈ iː k ə l
    بنجر	b ə n d͡ʒ ə r
    بھوٹیہ	bʱ ʊ ʈ iː ɑː
    ممالک	m ʊ m ɑː l ə k
    غلبہ	ɣ ʌ l b ɑː
    سینکڑوں	s eː n k ə r ʊ n
    بیٹسمےن	b eː ʈ s m ɛ n
    منسوخی	m ʊ n s ʊ x iː
    غصہ	ɣ ʊ s ɑː
    امیت	ʌ m iː t̪
    سازش	s ɑː z ɪ ʃ
    لازمی	l ɑː z m iː
    خونریز	x ʊ n r iː z
    طالب	ʈ ɑː l ɪ b
    پراڈکٹس	p ɾ ɑː ʈ ə k ʈ s
    اڑا	ʌ ɽ ɑː
    سست	s ʊ s t̪
    کلومیٹر	k ɪ l oː m iː ʈ ə r
    مالگاڑی	m ɑː l ɡ ɑː ɽ iː
    ایکڑ	eː k ə r
    پیٹ	p eː ʈ
    جارحانہ	d͡ʒ ɑː r ɦ ɑː n ɑː
    سگنل	s ɪ g n ə l
    اسٹائسٹکس	ɪ s ʈ ɑː ɪ s ʈ ɪ k s
    ناممکن	n ɑː m ʊ m k ə n
    واٹر	ʋ ɑː ʈ ə r
    علامت	ʌ l ɑː m ə t̪
    پیدائشی	p eː d̪ ɑː ɪ ʃ iː
    وزیرداخلہ	ʋ ʊ z iː r d̪ ɑː x l ɑː
    عبد	ʌ b d̪
    لکیج	l ə k iː d͡ʒ
    سرمئی	s ə r m eː ɪ
    مسلمان	m ʊ s l ɪ m ɑː n
    شعب	ʃ ʌ ʕ b
    دھوج	d̪ʱ ʊ d͡ʒ

    عکس	ʌ k s
    ناراض	n ɑː r ɑː z
    ایووکیڈو	ɛ j uː k iː d oʊ
    طبقات	t ɑː b q ɑː t
    مشاعرہ	m ʊ ʃ ɑː ɪ r ə
    بغیر	b ɪ ɣ ɛː r
    کوہ	k oʊ
    راشٹرپتی	r ɑː ʃ t r p ʌ t iː
    ٹیکساس	t ɛː k s ɑː s
    یزدانی	j ɛ z d ɑː n iː
    ناخوش	n ɑː x ʊ ʃ
    گیلانی	ɡ iː l ɑː n iː
    عالمی	ʌ ɑː l m iː
    ڈوگر	d oʊ ɡ r
    اندرا	ɪ n d r ɑː
    جانچنا	d͡ʒ ɑː n t͡ʃ n ɑː
    عمرہ	ʌ m r ə
    فلور	f l oʊ r
    پٹے	p ʌ t eɪ
    انفرنس	ɪ n f ɛ r n s
    فوارے	f oʊ ɑː r eɪ
    ضبط	z ʌ b t
    پارٹنرشپ	p ɑː r t n ɛ r ʃ ɪ p
    دوستی	d oʊ s t iː
    شان	ʃ ɑː n
    ومبلڈن	v ʌ m b l d ʌ n
    آمریت	ɑː m r iː t
    پھسل	pʰ ʌ s l
    پردہ	p ʌ r d ə
    ٹھکانا	tʰ ɪ k ɑː n ɑː
    اسٹون	ɪ s t oʊ n
    پنیسر	p ʌ n iː s ɛ r
    پرستش	p ʌ r s t ɪ ʃ
    گرانٹس	ɡ r ɑː n t s
    فعالیت	f ʌ ɑː l iː t
    پوچیا	p oʊ t͡ʃ iː ɑː
    نصرانی	n ʌ s r ɑː n iː
    بھارتیہ	bʰ ɑː r t iː ə
    بوائز	b oʊ z
    عروس	ʌ r oʊ s
    نوٹ	n oʊ t
    آڈیٹنگ	ɑː d ɪ t ɪ ŋ
    رنگاریڈی	r ʌ ŋ g ɑː r iː d iː
    سسرال	s ʌ s r ɑː l
    سیما	s iː m ɑː
    بیدر	b iː d r
    رفتہ	r ʌ f t ə
    روپے	r uː p eɪ
    لیگ	l iː ɡ
    چوبیس	t͡ʃ oʊ b iː s

    دوپہر	d̪ uː p ɛː ɾ
    احمدآباد	ɑː ɦ m ɛː d̪ ɑː b ɑː d̪
    نیاک	n iː ɑː k
    مکانپور	m ə k ɑː n p ɔː ɾ
    روایاتی	ɾ ɔː j ɑː t̪ iː
    ارسطو	ɑː ɾ s ʈ uː
    دفنانا	d̪ ə f n ɑː n ɑː
    قیدی	q iː d̪ iː
    شرط	ʃ ɛː ɾ ʈ
    صابن	s ɑː b n
    مانکیا	m ɑː n k iː ɑː
    چپل	t͡ʃ ə p ɛː l
    سرزمین	s ɛː ɾ z ə m iː n
    پیچھا	p iː t͡ʃʰ ɑː
    گیلانی	ɡ iː l ɑː n iː
    غمازی	ɣ ɪ m ɑː z iː
    ڈارا	ɖ ɑː ɾ ɑː
    گنا	ɡ ʊ n ɑː
    کچرہلز	k ʊ t͡ʃ ɾ ɛː l z
    گائناکالوجی	ɡ ɑː iː n ɑː k ɑː l oː d͡ʒ iː
    ٹکراؤ	ʈ ɪ k ɾ ɑː ʊ
    گڑیا	ɡ ə ɽ iː ɑː
    چرخہ	t͡ʃ ɪ ɾ x ɛː
    اوز	oː z
    ڈرونس	ɖ ɾ oː n s
    برس	b ɛː ɾ s
    شماری	ʃ ʊ m ɑː ɾ iː
    بڑھتا	b ə ɽʱ t̪ ɑː
    ڈوگر	ɖ oː ɡ ɛː ɾ
    طبقات	ʈ ɑː b q ɑː t̪
    سنجہا	s ʊ n d͡ʒ ɦ ɑː
    چنگل	t͡ʃ ʊ ŋ ɡ ɛː l
    وجیہ	ʋ ə d͡ʒ iː ɦ
    الم	ɑː l ə m
    جس	d͡ʒ ʊ s
    تاڑ	t̪ ɑː ɽ
    پرمیشور	p ɛː ɾ m eː ʃ ɔː ɾ
    المرزائی	ɑː l m ɛː ɾ z ɑː iː
    ایشن	eː ʃ ʊ n
    بسا	b ə s ɑː
    اوراد	oː ɾ ɑː d̪
    تدبیر	t̪ ə d̪ b iː ɾ
    ئن	ʔ ɪ n
    ٹرانزیشنل	ʈ ɾ ɑː n z iː ʃ ʊ n ɛː l
    گھرا	ɡʱ ɛː ɾ ɑː
    منظوری	m ʊ n z uː ɾ iː
    بنفشی	b ʊ n f ʃ iː
    اچت	ɑː t͡ʃ t̪
    پسند	p ə s ə n d̪
    طوطی	ʈ ɔː ʈ iː
حسین	ħ ʊ s eɪ n
دوچار	d oʊ t͡ʃ aː r
ہائیکورٹ	ɦ aɪ k ɔː r t̪
ڈیوڈ	ɖ iː oʊ ɖ
چائے	t͡ʃ aɪ ə
عبد	ʕ ʊ b d
پٹنہ	p ʌ t̪ n ə
سوتیلا	s oʊ t̪ iː l ɑː
زائد	z aɪ d
شاعری	ʃ aː ʕ r iː
خارج	x aː r ɪ d͡ʒ
الیکٹریسٹی	æ l iː k t̪ r ɪ s t̪ iː
کارنی	k aː r n iː
تب	t̪ ə b
مراسم	m ʊ r aː s ɪ m
یومی	j oʊ m iː
ہے	ɦ ɛː
نیننس	n eɪ n ə n s
عیادت	ʕ iː aː d̪ t̪
ورما	ʋ ɔː r m ɑː
نے	n eɪ
مظفر	m ʊ z f ə r
ایت	ɛː t̪
جوس	d͡ʒ oʊ s
کھانگ	kʰ aː n ɡ
ارکنساس	ɑː r k ə n s aː s
مارکٹس	m aː r k ɪ t̪ s
سلجھ	s ʊ l d͡ʒ ɦ
گندمی	ɡ ʊ n d̪ m iː
نانگل	n aː n ɡ ə l
دھن	d̪ʱ ʊ n
چیتاپور	t͡ʃ iː t̪ aː p ɔː r
نکسیر	n ɪ k s iː r
کھمم	kʰ ʊ m m
نتائج	n ɪ t̪ aː ɪ d͡ʒ
بڑھوتری	b ʌ ɽ ʊ t̪ ɾ iː
انعام	ɪ n ʕ aː m
متواتر	m ʊ t̪ ʋ aː t̪ ɾ
شرع	ʃ ʊ r ʕ
بٹور	b ʊ t̪ ɔː r
آگ	aː ɡ
کھلاڑی	kʰ ʊ l aː ɽ iː
ہمسفر	ɦ ʊ m s ə f ə r
قوانین	q ʋ aː n iː n
توحیدیت	t̪ ʋ ɛː ɦ iː d̪ iː t̪
کورٹ	k ɔː r t̪
ٹکٹس	ʈ ɪ k ʈ s
نصرانی	n ə s r aː n iː
توجہی	t̪ ʋ oʊ d͡ʒ ɛː iː
جامع	d͡ʒ aː m ɛː
چینلس	t͡ʃ iː n ə l s
یرموک	j ɪ r m uː k
بدھا	b ʊ d̪ʱ ɑː
چتا	t͡ʃ ʊ t̪ ɑː
کنٹرےکٹ	k ʊ n t̪ ɾ eɪ k t̪
نسبت	n ɪ s b ə t̪
برت	b ə r t̪
کیمیا	k eɪ m iː ɑː
برادرنسبتی	b ɾ ɑː d̪ ə r n ɪ s b ə t̪ iː
تیرھواں	t̪ iː r ʊ ɑː
لفٹ	l ɪ f t̪
شیوشنکر	ʃ iː ʊ ʃ ʊ n k ə r
بھونگیر	bʱ ʊ ŋ g iː r
سخت	s ʊ x t̪
غیردستوری	ɣ ɛː r d̪ ʊ s t̪ ʊ ɾ iː
جسونت	d͡ʒ ʊ s ʊ n t̪
جہازرانی	d͡ʒ ə ɦ ɑː z r ɑː n iː
پٹنہ	p ʌ t̪ n ɑː
برائے	b ɾ ɑː ɪ e
بھوگ	bʱ ʊ ɡ
نوٹس	n oʊ t̪ s
مترا	m ʊ t̪ r ɑː
دوپے	d̪ ʊ p eɪ
المسلمین	ʌ l m ʊ s l iː m iː n
عجب	ʕ ʤ ʌ b
اہلیہ	ɑː ɦ l iː ɑː
مصر	m ɪ s ɾ
مچلکہ	m ʊ t͡ʃ ʌ l k ɑː
کنٹیشور	k ʊ n t̪ iː ʃ ʊ ɾ
بریلی	b ɾ iː l iː
موظف	m ʊ z ʌ f
بلین	b ʌ l iː n
بےحد	b eɪ ɦ ʌ d̪
ینگ	j ɪ ŋ
بیدی	b eɪ d̪ iː
دفن	d̪ ʌ f n
تاڑ	t̪ ɑː ɽ
بلاآواز	b ʌ l ɑː ɑː ʋ ɑː z
جی	d͡ʒ iː
الیکشن	ʌ l iː k ʃ ʌ n
فورسٹ	f ɔː r s t̪
پردہ	p ʌ r d̪ ɑː
بھال	bʱ ɑː l
ویریا	ʋ iː r iː ɑː
فالکن	f ɑː l k ʌ n
سناتن	s ʊ n ɑː t̪ ʌ n
اپرادھی	ʌ p r ɑː d̪ʱ iː
سوتیلا	s ʊ t̪ iː l ɑː
جدول	d͡ʒ ʊ d̪ ʊ l
اسپیکٹرم	ʌ s p iː k t̪ ʌ r m

    دلیل	d̪ ɪ l iː l
    بےحیائی	b eː ɦ iː aː iː
    الیکشن	ə l iː k ʃ ə n
    پالیسی	p ɑː l iː s iː
    اچاریہ	ə t͡ʃ ɑː ɾ iː ə
    علما	ʕ ə l m ɑː
    پرنسپل	p ə ɾ n s p ə l
    لکشمی	l ə k ʃ m iː
    حلقہ	ɦ ə l q ə
    چاٹنا	t͡ʃ aː ʈ n ə
    اومیش	oː m iː ʃ
    ڈگر	ɖ ə ɡ ə ɾ
    کہنا	k ə ɦ n ə
    کیڈٹس	k eː ɖ ɪ t̪ s
    کشادہ	k ə ʃ aː d̪ ə
    کٹرپسند	k ʈ ə ɾ p s ə n d̪
    کنی	k ə n iː
    زاید	z aː ɪ d̪
    چیلنجس	t͡ʃ eː l ə n d͡ʒ s
    سوشیل	s oː ʃ iː l
    مفت	m ʊ f t̪
    فانی	f aː n iː
    باولی	b aː oː l iː
    میٹابولائز	m eː ʈ aː b oː l aː iː z
    عوامی	ʕ ʋ aː m iː
    مانے	m aː n eː
    پٹی	p ʈ iː
    ڈگ	ɖ ə ɡ
    رعیتوبازار	ɾ ʕ iː t̪ oː b aː z aː ɾ
    کچن	k ə t͡ʃ ə n
    گدھ	ɡ ə d̪ʱ
    بودھن	b oː d̪ʱ ə n
    گھنٹا	ɡʱ ə n ʈ aː
    مکتوب	m ʊ k t̪ oː b
    پرمیشور	p ə ɾ m eː ʃ oː ɾ
    چیٹا	t͡ʃ iː ʈ aː
    فٹنس	f ɪ t̪ n s
    جنم	d͡ʒ ə n m
    وفاقی	ʋ ə f aː q iː
    لکشمیا	l ə k ʃ m iː aː
    راس	ɾ aː s
    کیڑا	k iː ɽ aː
    گندا	ɡ ə n d̪ ə
    کامرس	k aː m ə ɾ s
    پیکیج	p eː k iː d͡ʒ
    بےہوش	b eː ɦ oː ʃ
    گفتگو	ɡ ʊ f t̪ ɡ oː
    بتدریج	b ə t̪ d̪ ɾ iː d͡ʒ
    شنتانو	ʃ ə n t̪ aː n uː
    فالکن	f aː l k ə n
مایاوتی	m aː j aː ʋ ə t̪ iː
ہوڑا	ɦ ʋ ɔː ɽ aː
اذیت	ə z iː t̪
ایکسپریس	aɪ k s p ɾ iː s
تیکھا	t̪ iː kʰ aː
یوسف	j uː s ə f
دیرینہ	d̪ iː ɾ iː n ə
گجویل	ɡ ə d͡ʒ ʋ ə iː l
پارلیمنٹ	p aː ɾ l iː m ə n ʈ
لیگ	l iː ɡ
منظوری	m ə n z ʊ ɾ iː
انڈر	ə n ʈ ɾ
ذمہ۔دار	z ə m ɦ ə d̪ aː ɾ
رائےدہی	ɾ aː ɪ ə d̪ ɦ iː
رومس	ɾ uː m s
میراں	m iː ɾ aː n
جیل	d͡ʒ iː l
کمپنی	k ə m p n iː
عالمی	ʕ aː l m iː
نقش	n ə q ʃ
ورون	ʋ ə ɾ uː n
دستی	d̪ ə s t̪ iː
ماہ	m aː ɦ
رسٹورنٹس	ɾ ə s ʈ ɔː ɾ ə n ʈ s
تاڑ	t̪ aː ɽ
فیکلٹی	f iː k l ʈ iː
ابھشیک	ə bʱ ʃ iː k
كر	k ə ɾ
وشوکت	ʋ ə ʃ ʋ oː k ə t̪
مہربند	m ə ɦ ɾ b ə n d̪
دہندہ	d̪ ə ɦ n d̪ ə
روگردانی	ɾ oː ɡ ə ɾ d̪ aː n iː
ممالک	m ə m aː l ə k
سہمنا	s ə ɦ m n ɑː
اسپاٹ	ə s p aː ʈ
انتم	ə n t̪ ə m
کمبلے	k ə m b l eː
اندھیرا	ə n d̪ʱ iː ɾ aː
حسنی	ɦ ə s n iː
نورین	n ʊ ɾ iː n
سائیٹ	s aː iː ʈ
کارپوریٹر	k aː ɾ p ɔː ɾ iː ʈ ə ɾ
چربی	t͡ʃ ə ɾ b iː
تعاونی	t̪ ʕ aː ʋ n iː
سازش	s aː z ɪ ʃ
غفلت	ɣ ə f l ə t̪
کنٹیشور	k ə n ʈ iː ʃ ɔː ɾ
رہنمائے	ɾ ə ɦ n ə m aː ɪ
ہنومان	ɦ ə n ʋ oː m aː n
صلاح	s ə l aː ɦ

    شین	ʃ iː n
    اردن	ɑː r d̪ ə n
    ہمدردی	ɦ ə m d̪ ə r d̪ iː
    مارکٹس	m ɑː r k ɪ t̪ s
    مہربن	m ə ɦ r b ə n
    پابند	p ɑː b ə n d̪
    افتتاح	ɑː f t̪ t̪ ɑː ɦ
    روایت	r ʋ ɑː j ə t̪
    ٹیلی	ʈ iː l iː
    حسین	ɦ ʊ s eɪ n
    بےجا	b eː d͡ʒ ɑː
    ازم	ɑː z m
    سلوک	s ə l ʋ ɔː k
    گردوارہ	ɡ ə r d̪ ʋ ɑː r ɑː
    باز	b ɑː z
    مالک	m ɑː l ɪ k
    انوراللہ	ɑː n ʋ ə r ɑː l l ɑː ɦ
    انشورنس	ɪ n ʃ ʊ r ə n s
    جوگی	d͡ʒ ɔː ɡ iː
    ملائیشیا	m ə l ɑː ɪ ʃ iː ɑː
    اکرام	ɑː k r ɑː m
    افتخار	ɑː f t̪ ɪ x ɑː r
    بھاری	bʱ ɑː r iː
    جونیر	d͡ʒ ʊ n iː ɾ
    سوامی	s ʋ ɑː m iː
    انٹرنیشنل	ɪ n ʈ ə r n iː ʃ ə n ə l
    حصول	ɦ ʊ s uː l
    منظوری	m ə n z ʊ r iː
    بشمول	b ə ʃ m ʊ l
    شنید	ʃ ə n iː d̪
    فٹنس	f ɪ t̪ n ə s
    انڈر۔پاس	ɪ n d̪ ə r p ɑː s
    قانون	q ɑː n uː n
    پیڑ	p eː ɽ
    تنگ	t̪ ə ŋ ɡ
    کارخانہ	k ɑː r x ɑː n ɑː
    واقعاتی	ʋ ɑː q eː ɑː t̪ iː
    باقاعدگی	b ɑː q ɑː ɪ d̪ ɡ iː
    ریمارک	r eɪ m ɑː r k
    اطباء	ɪ t̪ ɪ b ɑː ɑː
    یونٹس	j ʊ n ɪ t̪ s
    کے	k eː
    جائے	d͡ʒ ɑː ɪ
    عاص	ʕ ɑː s
    انتہاپسندی	ɪ n t̪ ɦ ɑː p s ə n d̪ iː
    سیکڑوں	s eɪ k ɽ ʊ n
    راجا	r ɑː d͡ʒ ɑː
    کوڈا	k ʊ d̪ ɑː
    مقامی	m ʊ q ɑː m iː
    ثقافت	θ ɪ q ɑː f t̪

    جوگی	d͡ʒ oː ɡ iː
    عامہ	ʕ ɑː m ə
    موجھی	m oː d͡ʒ ʱ iː
    چیلنج	t͡ʃ eː l n d͡ʒ
    اکثریت	ʔ ʊ k s ʊ r iː t̪
    نفس	n ə f s
    برف	b ə r f
    دھوسر	d̪ʱ uː s ə r
    فلو	f l oː
    جارجیا	d͡ʒ ɑː r d͡ʒ iː ɑː
    اطفال	ʔ ɪ t̪ f ɑː l
    اولمپک	ʔ aʊ l m p ɪ k
    صدرجمہوریہ	s ʊ d ə r d͡ʒ ʊ m ʰ uː r iː ə
    جھوٹی	d͡ʒ ʱ uː ʈ iː
    جبری	d͡ʒ ʊ b r iː
    گین	ɡ eː n
    کھلاڑی	kʰ l ɑː ɽ iː
    دندنا	d ə n d ə n ɑː
    کارکرد	k ɑː r k ə r d̪
    وغیرہ	ʋ ə ɣ ɛː r ə
    ابن	ʔ ɪ b n
    حالت	ɦ ɑː l ə t̪
    بہت	b ə ɦ ʈ
    بحیثیت	b ɛː ɦ eː s iː t̪
    کیئر	k eː ʔ ə r
    معین	m ʊ ʔ iː n
    گلاس	ɡ l ɑː s
    قیمتی	q iː m t̪ iː
    کمرے	k ʊ m r ɛː
    وفاق	ʋ ɪ f ɑː q
    اظہر	ʔ ɪ z ʱ ə r
    متوفی	m ʊ t̪ ʋ ɔː f iː
    چوم	t͡ʃ uː m
    ڈین	ɖ iː n
    وزیرداخلہ	ʋ ə z iː r d̪ ɑː x l ə
    کیابس	k iː ɑː b s
    مصر	m ɪ s ɾ
    منیجر	m ə n iː d͡ʒ ə r
    پرکاش	p ə r k ɑː ʃ
    عسکریت۔پسند	ʕ ʊ s k ə r iː t̪ p ʊ s n ə d̪
    ابودرداء	ʔ ɑː b uː d ə r d ɑː ʔ
    اوسو	ʔ oː s oː
    جگدیشور	d͡ʒ ʊ ɡ d̪ iː ʃ uː r
    رپورٹرس	ɾ ə p ɔː r ʈ ə r s
    فعالیت	f ʕ ɑː l iː t̪
    ایلینا	ʔ eː l iː n ɑː
    راہداری	ɾ ɑː ɦ d̪ ɑː ɾ iː
    روزنامہ	ɾ oː z n ɑː m ə
    غداری	ɣ ʊ d̪ ɑː r iː
    عیسائی	ʕ iː s ɑː ʔ iː

    ٹرینس	ʈ r eɪ n s
    گاڑ	g ɑː r
    رخ	r ʊ x
    خاتمہ	x ɑː t̪ ɪ m ɑː
    زائد	z ɑː ɪ d
    جھوٹی	d͡ʒ ʱ uː ʈ iː
    کیوی	k iː w iː
    دھاندلی	d̪ʱ ɑː n d̪ l iː
    واقعاتی	w ɑː q eɪ ɑː t̪ iː
    طینت	ʈ ɪ n t̪
    ماک	m ɑː k
    ہوڑا	ɦ ʊ r ɑː
    مولوی	m uː l oʊ w iː
    کھلاڑی	kʰ l ɑː ɽ iː
    محفوظ	m ʊ h f oː z
    سنتوش	s ʊ n t̪ oʊ ʃ
    رکوع	r ʊ k uː ʕ
    چوبیس	t͡ʃ oʊ b iː s
    سنگین	s ʊ ŋ g iː n
    نانگل	n ɑː n g l
    نہس	n ɛ h s
    کوہ	k oʊ ɦ
    مخاطب	m ʊ x ɑː t̪ ɪ b
    ٹھہراؤ	ʈʰ ɛ ɦ r ɑː oʊ
    ون	w ʊ n
    فیریرو	f eɪ r iː r oʊ
    شنتانو	ʃ ʊ n t̪ ɑː n oʊ
    آخرالزماں	ɑː x ɪ r ʌ l z ʊ m ɑː n
    ایشن	eɪ ʃ ʊ n
    ٹیکسی	ʈ iː k s iː
    کہاکہ	k ɛ ɦ ɑː k ɛ ɦ
    تروپتی	t̪ r oʊ p t̪ iː
    قابل	q ɑː b ɪ l
    سرزمین	s ʊ r z ʊ m iː n
    ادھو	ʌ d̪ʱ oʊ
    مکتوب	m ʊ k t̪ oʊ b
    غیرمستحکم	ɣ ɪ r m ʊ s t̪ ɦ ʌ k ʌ m
    سنا	s ʊ n ɑː
    وفاقی	w ʊ f ɑː q iː
    بہنا	b ɛ ɦ n ɑː
    شمولیت	ʃ ʊ m oʊ l iː t̪
    غیرسرکاری	ɣ ɪ r s ʊ r k ɑː r iː
    روبہ	r oʊ b ɛ ɦ
    مذکرہ	m ʊ z k ɛ r ɑː
    جوس	d͡ʒ oʊ s
    ڈیسک	ɖ iː s k
    رگھوناتھ	r ʊ gʱ oʊ n ɑː t̪ʰ
    ساتھ	s ɑː t̪ʰ
    مردانہ	m ʊ r d̪ ɑː n ɑː
    ضلاع	z ɪ l ɑː ʕ
دوپے	d̪ oː p eː
اسپنر	ə s p n ə ɾ
صدی	s ə d̪ iː
استوار	ə s t̪ ʋ ɑː ɾ
اجناس	ə d͡ʒ n ɑː s
طبقہ	t̪ ə b q ə
قرعہ	q ə ɾ ʕ ə
ارسال	ə ɾ s ɑː l
بموجب	b ə m ʊ d͡ʒ ɪ b
اخراجات	ə x ɾ ɑː d͡ʒ ɑː t̪
چھینک	t͡ʃʰ iː n k
شماری	ʃ ʊ m ɑː ɾ iː
گدھ	ɡ ə d̪ʱ
گاڑ	ɡ ɑː ɽ
سیوریج	s iː ʋ ə ɾ ɪ d͡ʒ
کھڑی	kʰ ə ɽ iː
ویٹ	ʋ eː ʈ
ہلڑ	ɦ ə l ɽ
قباحت	q ə b ɑː ɦ ə t̪
غزہ	ɣ ə z ə
کارڈ	k ɑː ɽ d̪
کچن	k ə t͡ʃ n
ترپاٹھی	t̪ ə ɾ p ɑː t̪ʰ iː
رفت	ɾ ə f t̪
مالک	m ɑː l ɪ k
چیٹا	t͡ʃ iː ʈ ɑː
فلاحی	f ə l ɑː ɦ iː
چکنائی	t͡ʃ ə k n ɑː iː
ماسٹر	m ɑː s ʈ ə ɾ
چیرپرسن	t͡ʃ eː ɾ p ə ɾ s ə n
پرمیشور	p ə ɾ m eː ʃ ɔː ɾ
ارش	ə ɾ ʃ
گود	ɡ uː d̪
جٹا	d͡ʒ ə ʈ ɑː
فیالوقت	f iː ɑː l ʋ ə q t̪
عزا	ʕ ə z ɑː
اسٹارس	ə s ʈ ɑː ɾ s
چٹس	t͡ʃ ə ʈ s
جھک	d͡ʒʱ ə k
مانشیرا	m ɑː n ʃ iː ɾ ɑː
آبسٹیٹرکس	ɑː b s ʈ iː ʈ ə ɾ k s
تقریباً	t̪ ə q ɾ iː b ɑː
پستہ	p ə s t̪ ə
تحریک	t̪ ə ɦ ɾ iː k
فورسی	f ɔː ɾ s iː
اخذ	ə x z
نیلا	n iː l ɑː
دھل	d̪ʱ ə l
فیڈنگ	f iː d̪ ɪ ŋ ɡ
مرنا	m ə ɾ n ɑː

    اسپاٹ	ɪ s p ɑː ʈ
    ڈائریا	ɖ ɑː ɪ ɾ iː ɑː
    برخلاف	b ɪ ɾ x ɪ l ɑː f
    ناپاک	n ɑː p ɑː k
    غور	ɣ ʊ ɾ
    سوپر	s uː p ɪ ɾ
    پیشاب	p eː ʃ ɑː b
    اعزازی	ɑː ɪ z ɑː z iː
    کچن	k ʊ t͡ʃ n
    پھیلی	pʰ eː l iː
    شک	ʃ ʊ k
    بدلنا	b ʊ d̪ l n ɑː
    کشیدگی	k ʊ ʃ iː d̪ ɡ iː
    تضاد	t̪ ʊ z ɑː d̪
    ثناخوان	θ n ɑː x w ɑː n
    لائے	l ɑː ɪ eː
    انفوٹی	ɪ n f oʊ ʈ iː
    چنگل	t͡ʃ ʊ ŋ ɡ ʊ l
    تیرھواں	t̪ ɪ ɾ ʊ w ɑː n
    انفراسٹرکچر	ɪ n f r ɑː s t̪ ɾ ʊ k t̪ʃ ʊ ɾ
    مسلح	m ʊ s l ɛ ɦ
    ٹائیلس	ʈ ɑː ɪ l s
    آبسٹیٹرکس	ɑː b s ʈ iː ʈ ɪ ɾ k s
    وسلم	v ʊ s ʊ l m
    وہ	v ʊ ɦ
    کوچس	k oʊ t͡ʃ s
    اگرچیکہ	ʊ ɡ ɾ t͡ʃ iː k ɛ ɦ
    گز	ɡ ʊ z
    مذکرہ	m ʊ z k ɪ ɾ ɑː
    پری	p ɪ ɾ iː
    راہداری	ɾ ɑː ɦ d̪ ɑː ɾ iː
    طاقتور	ʈ ɑː q t̪ ʊ ɾ
    ٹیچر	ʈ iː t͡ʃ ɪ ɾ
    ماریشیس	m ɑː ɾ iː ʃ ɪ s
    دلیری	d̪ ɪ l iː ɾ iː
    سنجیدگی	s ʊ n d͡ʒ iː d̪ ɡ iː
    سابقہ	s ɑː b iː q ɑː
    لداخ	l ʊ d̪ ɑː x
    سربیائی	s ɪ ɾ b iː ɑː ɪ
    رنگت	ɾ ʊ ŋ ɡ ʊ t̪
    ایذارسانیوں	ɑː ɪ ð ɑː ɾ s ɑː n iː ʊ n
    سیریز	s iː ɾ iː z
    مخبر	m ʊ x b ɪ ɾ
    واقعاتی	v ɑː q eː ɑː t̪ iː
    صلاح	s ʊ l ɑː ɦ
    فلاحی	f l ɑː ɦ iː
    ایشیائی	ɑː ɪ ʃ iː ɑː ɪ
    سدھارنا	s ʊ d̪ʱ ɑː ɾ n ɑː
    بدھا	b ʊ d̪ʱ ɑː
    چندناکھن	t͡ʃ ʊ n d̪ n ɑː kʰ n
انڈسٹریل	ɪ n ɖ ʊ s t̪ r iː l
روبہ	r oː b ɑː
چاہت	t͡ʃ ɑː ɦ ə t̪
احد	ɑː ɦ ə d̪
بیٹے	b eː ʈ eː
فریقی	f ə r iː q iː
قلم	q ə l ə m
نالے	n ɑː l eː
تب	t̪ ə b
كر	k ə r
خیرسگالی	x eː r s ɡ ɑː l iː
امام	ɑː m ɑː m
دوران	d̪ oː r ɑː n
مفاہمت	m ʊ f ɑː ɦ ɪ m ə t̪
مقدر	m ʊ q d̪ ə r
درسگاہ	d̪ ə r s ɡ ɑː ɦ
بچہ	b ə t͡ʃ ɑː
ڈھانچہ	ɖʱ ɑː n t͡ʃ ɑː
ادعا	ɑː d̪ ʊ ɑː
راجو	r ɑː d͡ʒ oː
کولکاتا	k oː l k ɑː t̪ ɑː
میاتھمیٹکس	m j ɑː t̪ʰ m iː ʈ ɪ k s
انتم	ɪ n t̪ ə m
ململ	m ʊ l m ʊ l
کورٹ	k ɔː r ʈ
جنم	d͡ʒ ə n ə m
چوبیس	t͡ʃ oː b iː s
شہادت	ʃ ə ɦ ɑː d̪ ə t̪
جھگڑا	d͡ʒʱ ɡ ə ɽ ɑː
یوم	j oː m
ابھیجیت	ə bʱ iː d͡ʒ iː t̪
میدان	m eː d̪ ɑː n
محدود	m ə ɦ d̪ uː d̪
ڈال	ɖ ɑː l
فوری	f oː r iː
ویزا	ʋ iː z ɑː
الم	ɑː l ə m
لوسان	l oː s ɑː n
مانکیا	m ɑː n k iː ɑː
دل	d̪ ɪ l
متحدہ	m ʊ t̪ ɦ ɛ d̪ ɑː
کیمیکل	k iː m iː k ə l
مباین	m ʊ b ɑː j n
چوبے	t͡ʃ oː b eː
کھیلنا	kʰ eː l n ɑː
انحراف	ɪ n ɦ ɪ r ɑː f
درجہ	d̪ ə r d͡ʒ ɑː
فورتھ	f oː r t̪ʰ
گھاٹا	ɡʱ ɑː ʈ ɑː
جٹا	d͡ʒ ə ʈ ɑː
بائیسکل	b aɪ s k ə l
متقاضی	m ʊ t̪ q aː z iː
ٹرانزیشنل	ʈ r aː n z iː ʃ ə n ə l
سکو	s k uː
کودنڈا	k uː d n ɖ aː
چھینک	t͡ʃʰ iː n k
خریدی	x ə r iː d iː
پریمئر	p r eɪ m ɪə r
لکشمیا	l ə k ʃ m iː aː
شکایات	ʃ iː k aː j aː t̪
الگ	ʌ l ɡ
درس	d ə r s
قدرت	q ʊ d ɾ ə t̪
کروڈ	k ə r oː ɖ
سوا	s ʊ aː
سائیٹ	s aɪ ʈ
قاصر	q aː s ə r
دیانتداری	d iː aː n ə t̪ d aː r iː
اسٹال	ɪ s ʈ aː l
ناظم	n aː z ə m
دشت	d ə ʃ t̪
پیلاگو	p iː l aː ɡ oː
اروکھ	aː r oː kʰ
ندیاں	n ə d iː aː n
میاں	m iː aː n
کیسی	k eɪ s iː
کارنی	k aː r n iː
شوارع	ʃ oː aː r ʕ
عاقد	ʕ aː q ə d
دکھانا	d ə kʰ aː n aː
اوقافی	oː q aː f iː
نقطہ	n ʊ q t̪ ʰ aː
ہائی	ɦ aɪ
لاگو	l aː ɡ oː
بہیمانہ	b ə h iː m aː n ə
تھیراپی	t̪ʰ eɪ r aː p iː
القرآن	ʌ l q ʊ r aː n
نظر	n ə z ə r
خطیر	x ə t̪ iː r
زاید	z aː ɪ d
ڈیسک	ɖ iː s k
تعصبیت	t̪ ʕ ʌ s b iː t̪
بشرط	b ə ʃ ɾ ʈ
اطفال	ɪ t̪ f aː l
ذائقہ	z aː ɪ q ə
شرن	ʃ ə r n
برہان	b ə r ɦ aː n
نشانی	n ə ʃ aː n iː
میراں	m iː r aː n
خاصکر	x aː s k ə r
کشٹاریڈی	k ʊ ʃ t̪ ɑː ɾ iː d̪ iː
عسکریت۔پسند	ʌ s k ɛ ɾ iː t̪ p ʊ s n ʊ n d̪
کھلاڑی	kʰ ɪ l ɑː ɽ iː
ورنگل	ʋ ɔː r n ɡ ʌ l
ایسی	aɪ s iː
خالق	x ɑː l ɪ q
انکاؤنٹر	ɪ n k aʊ n t̪ ɛ r
وسنت	ʋ ʊ s n ʌ t̪
الطاف	ʌ l t̪ ɑː f
مایوس۔کن	m aɪ j ʊ s k ʊ n
منی	m ʊ n iː
گجنی	ɡ ʊ d͡ʒ n iː
دھمکا	d̪ʱ ʊ m k ɑː
چیمپین	t͡ʃ iː m p iː n
روزگار	ɾ oː z ɡ ɑː r
بنجر	b ʊ n d͡ʒ ɛ r
ہنس	ɦ ʊ n s
بریگیڈیر	b ɾ iː ɡ eɪ d̪ iː r
چھتری	t͡ʃʰ ʊ t̪ ɾ iː
لائینز	l aɪ n z
یچوری	j ɛ t͡ʃ oː r iː
ناکامی	n ɑː k ɑː m iː
سربرآوردہ	s ɛ r b ɛ r ɑː ʋ ɛ r d̪ ɑː
آئیڈیا	ɑː ɪ d̪ iː ɑː
متعلق	m ʊ t̪ ʌ l ɪ q
پرنم	p ɛ r n ʌ m
نائٹ	n aɪ t̪
دیرینہ	d̪ eɪ r iː n ɑː
المرزائی	ʌ l m ɛ r z aɪ iː
نارا	n ɑː r ɑː
بیوی	b eɪ ʋ iː
واقف	ʋ ɑː q ɪ f
مکر	m ʊ k ɾ
ہائی۔ٹیکس	ɦ aɪ t̪ ɛ k s
تعاونی	t̪ ʌ ɑː ʋ n iː
وسعت	ʋ ʊ s ʌ t̪
چوڑا	t͡ʃ ʊ ɽ ɑː
جوان	d͡ʒ ʋ ɑː n
گرفتارشدہ	ɡ ɛ r f t̪ ɑː r ʃ ʊ d̪ ɑː
شلپا	ʃ ʊ l p ɑː
نان	n ɑː n
غلبہ	ɡʱ ʊ l b ɑː
زخم	z ʌ x m
کھلواڑ	kʰ ʊ l ʋ ɑː ɽ
کھمم	kʰ ʊ m m
مبشر	m ʊ b ʃ ɛ r
چکنائی	t͡ʃ ʊ k n aɪ iː
راہداری	ɾ ɑː ɦ d̪ ɑː ɾ iː
مادری	m ɑː d̪ ɛ r iː
دستبردار	d̪ ʊ s t̪ b ɛ r d̪ ɑː r
معدنیات	m ʊ ʔ d̪ ə n iː ɑː t̪
رحمت	ɾ ə ɦ m ə t̪
ستیا	s ʊ t̪ iː ɑː
باقاعدگی	b ɑː q ɑː ʔ ɪ d̪ ɡ iː
کروڑ	k ə ɾ oː ɽ
لارینس	l ɑː ɾ iː n s
دستاویزات	d̪ ə s t̪ ɑː ʋ iː z ɑː t̪
جھوٹ	d͡ʒ ʱ uː ʈ
بالے	b ɑː l eː
شے۶	ʃ eː ʧʰ ʰ
ایل	ɑː ɪ l
ببھکشا	b ə bʱ ə kʃ ɑː
سائنسی	s ɑː ʔ ɪ n s iː
کمرے	k ə m ɾ eː
نارا	n ɑː ɾ ɑː
سرپنچ	s ə ɾ p ə n t͡ʃ
للن	l ʊ l ə n
گنا	ɡ ʊ n ɑː
عینی	ʔ ɛː n iː
رامیا	ɾ ɑː m iː ɑː
حکمرانی	ɦ ʊ k ʊ m ɾ ɑː n iː
جگدیشور	d͡ʒ ʊ ɡ d̪ iː ʃ ʊ ɾ
ون	ʋ ʊ n
خواہشمند	x ʋ ɑː ɦ ɪ ʃ m ʊ n d̪
ارادہ	ʔ ɪ ɾ ɑː d̪ ə
وارسا	ʋ ɑː ɾ s ɑː
غیرانسانی	ɣ ɛː r ɪ n s ɑː n iː
راجیم	ɾ ɑː d͡ʒ iː m
مروڑ	m ə ɾ oː ɽ
دھو	d̪ʱ uː
گھڑیال	ɡʱ ə ɽ iː ɑː l
لکژری	l ʊ kʒ ə ɾ iː
آئیرن	ɑː ɪ ɾ ə n
مرحومہ	m ə ɾ ɦ uː m ə
کودنڈا	k ʊ d̪ n ʊ n d̪ ɑː
بانچنا	b ɑː n t͡ʃ n ɑː
جھگڑا	d͡ʒʱ ə ɡ ɽ ɑː
چیمپین	t͡ʃ iː m p iː n
باک	b ɑː k
تحفظ	t̪ ə ɦ f ə z
بیگز	b eː ɡ z
ٹکٹس	ʈ ɪ k ʈ s
بحیثیت	b ɦ ɪ s iː t̪
الداخلہ	ʔ ə l d̪ ɑː x l ə
دوران	d̪ ʊ ɾ ɑː n
دیواکر	d̪ iː ʋ ɑː k ə ɾ
نورین	n ʊ ɾ iː n
دعوہ	d̪ ʊ ʔ ɑː
مہارانی	m ə ɦ ɑː ɾ ɑː n iː
ووٹ	ʋ uː ʈ

    کلب	k ʊ l b
    تلاش	t ə l ɑː ʃ
    عالمی	ʕ ɑː l ə m iː
    پرمیشور	p ə r m eː ʃ ɔː r
    پردیپ	p ə r d iː p
    وینکٹ	ʋ eː n k ʈ
    اکثریت	ʔ ʊ k s ʊ r iː t̪
    کمل	k ʊ m l
    عبدالعزیز	ʕ ʊ b d ʊ l ʕ ʊ z iː z
    گردوارہ	ɡ ʊ r d ʋ ɑː r ɑː
    جٹ	d͡ʒ ʌ ʈ
    پرتبھا	p ə r t̪ ʊ bʱ ɑː
    شیواجی	ʃ iː ʋ ɑː d͡ʒ iː
    یوگیتا	j oː ɡ iː t̪ ɑː
    آلراؤنڈر	ɑː l r aʊ n d̪ ə r
    مہندا	m ə ɦ n d ɑː
    مہنگی	m ə ɦ n ɡ iː
    انفرنس	ɪ n f ə r n ə s
    روا	r ʋ ɑː
    زخم	z ə x m
    رشادی	r ə ʃ ɑː d iː
    نمائندہ	n ʊ m ɑː ɪ n d ə ɦ
    ٹیکساس	ʈ iː k s ɑː s
    اساس	ʔ ə s ɑː s
    مقفل	m ʊ q f ʊ l
    توجہی	t̪ ʋ oː d͡ʒ ɦ iː
    انہوں	ʔ ʊ n ɦ ʊ n
    گائیڈنس	ɡ ɑː iː d̪ n s
    کارگزاری	k ɑː r ɡ ʊ z ɑː r iː
    وسلم	ʋ ʊ s l ʊ m
    بوتے	b ʊ t̪ eː
    رجوران	r ə d͡ʒ ʊ r ɑː n
    عبید	ʕ ʊ b eː d̪
    لہجہ	l ə ɦ d͡ʒ ə
    پورم	p ʊ r m
    رات	r ɑː t̪
    مطابق	m ʊ t̪ ɑː b ɪ q
    ہنگامہ	ɦ ʊ ŋ ɡ ɑː m ə
    لیفٹیننٹ	l iː f ʈ iː n ə n ʈ
    قابض	q ɑː b ɪ z
    ساتویں	s ɑː t̪ ʋ eː n
    اوپینین	oː p iː n iː n
    تھکا	t̪ʰ ə k ɑː
    انہدامی	ʔ ʊ n ɦ d ɑː m iː
    روزگار	r oː z ɡ ɑː r
    ریکارڈکردہ	r eː k ɑː r ʈ k ʊ r d ə ɦ
    رنجن	r ʊ n d͡ʒ ʊ n
    اترنا	ʔ ʊ t̪ ə r n ɑː
    سپرد	s ʊ p ə r d̪
    الشیخ	ʔ ʊ l ʃ eː x
میرے	m iː ɾ eː
جانی	d͡ʒ ɑː n iː
حالت	ɦ ɑː l ə t̪
بڑھتا	b ə ɽʱ t̪ ɑː
پالکرتی	p ɑː l k ə ɾ t̪ iː
مرنا	m ə ɾ n ɑː
بریہ	b ə ɾ iː ɦ
تخلیہ	t̪ ə x l iː ɦ ɑː
پاور	p ɑː ʋ ə ɾ
دھماکہ	d̪ʱ ʊ m ɑː k ə ɦ
غزوۂ	ɣ ə z ʋ ɛː
خبریں	x ə b ɾ iː n
فنڈ	f ʊ n ɖ
چانسلر	t͡ʃ ɑː n s ə l ə ɾ
ارش	ɑː ɾ ʃ
تجدید	t̪ ə d͡ʒ d̪ iː d̪
ترملگیری	t̪ ə ɾ m ə l ɡ iː ɾ iː
ہیڈکوارٹر	ɦ eː ɖ k ʋ ɑː ɾ ʈ ə ɾ
سری۔لنکائی	s ə ɾ iː l ə n k ɑː iː
فراخ۔دل	f ə ɾ ɑː x d̪ ɪ l
معتمد	m ʊ ʔ t̪ ə m ɪ d̪
سامل	s ɑː m ə l
دوچار	d̪ ʊ t͡ʃ ɑː ɾ
روپوش	ɾ ʊ p ʊ ʃ
سہمانا	s ə ɦ m ɑː n ɑː
استعفے	ɪ s t̪ ɪ ʕ f ɛː
مجرمانہ	m ʊ d͡ʒ ɾ ɪ m ɑː n ɑː
کمپٹرولر	k ʌ m p ʊ ʈ ɾ oʊ l ə ɾ
مکر	m ʊ k ə ɾ
ڈگ	ɖ ə ɡ
پردیب	p ə ɾ d̪ iː b
سرسید	s ə ɾ s iː d̪
سید	s eː d̪
رکوع	ɾ ʊ k uː ʕ
دلیری	d̪ ə l iː ɾ iː
اندیشہ	ɪ n d̪ iː ʃ ɑː
اطالیہ	ɪ t̪ ɑː l iː ɑː
ہائیکورٹ	ɦ aː iː k ɔː ɾ ʈ
بہیرہ	b ə ɦ eː ɾ ɑː
تب	t̪ ə b
چترویدی	t͡ʃ ə t̪ ɾ ʊ ʋ eː d̪ iː
اترپردیش	ʊ t̪ ə ɾ p ə ɾ d̪ eː ʃ
پ	p
پدما	p ə d̪ m ɑː
پیٹ	p eː ʈ
کلومیٹر	k ɪ l oʊ m iː t̪ ə ɾ
اسٹیون	ɪ s t̪ iː ʋ ə n
فاروق	f ɑː ɾ ʊ q
اگرچیکہ	ə ɡ ə ɾ t͡ʃ iː k ɛː
ارسطو	ɑː ɾ s t̪ ʊ
متذکرہ	m ʊ t̪ ð ɪ k ɾ ɑː
بابری	b ɑː b ɾ iː
لوگ	l oː ɡ
ہستم	ɦ ə s t̪ ə m
چیز	t͡ʃ iː z
ورما	ʋ ɔː ɾ m ɑː
دشواری	d̪ ʊ ʃ ʋ ɑː ɾ iː
نان	n ɑː n
نسبت	n ɪ s b ə t̪
بٹور	b ʊ t̪ ɔː ɾ
جنگل	d͡ʒ ʊ ŋ ɡ ə l
بعدازاں	b ʌː d̪ ɑː z ɑː n
شاداب	ʃ ɑː d̪ ɑː b
پٹرولیم	p ʌ t̪ ɾ oː l iː m
توصیف	t̪ ʊ s iː f
طلبہ	t̪ ɑː l ɪ b ɑː
گھنٹہ	ɡʱ ʊ n ʈ ɑː
فیڈرر	f eː d̪ ɾ ɾ
گردوارہ	ɡ ʊ ɾ d̪ ʋ ɑː ɾ ɑː
درشی	d̪ ɾ ʃ iː
غیرمنافع	ɣ ɛː ɾ m ə n ɑː f ɪ ʕ
کاپٹر	k ɑː p ʈ ɾ
لوتھ	l oː t̪ʰ
دھرنہ	d̪ʱ ɾ ə n ɑː
ٹکٹس	ʈ ɪ k ʈ s
استاد	ə s t̪ ɑː d̪
اصل	ə s l
آفسیر	ɑː f s iː ɾ
ملزمین	m ʊ l z ɪ m iː n
شروع	ʃ ʊ ɾ uː ʕ
دستاویزی	d̪ ə s t̪ ɑː ʋ iː z iː
فی۔الحال	f eː ɑː l ɦ ɑː l
اصغر	ə s ɣ ɑː ɾ
ہاما	ɦ ɑː m ɑː
ترملگیری	t̪ ɾ m ə l ɡ iː ɾ iː
رنڈی	ɾ ə n ʈ iː
اگان	ə ɡ ɑː n
کھوکس	kʰ oː k s
لوشیا	l oː ʃ iː ɑː
کنٹک	k ə n ʈ ɪ k
وطن	ʋ ə t̪ ə n
لحاظ	l ɪ ɦ ɑː z
ولتھاٹی	ʋ ə l t̪ʰ ɑː ʈ iː
وزیرستان	ʋ ə z iː ɾ ə s t̪ ɑː n
پڑھ	p ɽʱ
مہاوت	m ə ɦ ɑː ʋ ə t̪
سیلسیس	s iː l s iː s
سمپرداے	s ə m p ɾ ə d̪ ɑː eː
سنا	s ʊ n ɑː
بموجب	b ə m ʊ d͡ʒ ɪ b

    لکشمن	l ʊ k ʃ m ʊ n
    عمرہ	ʕ ʊ m r ə
    الیکٹرولائٹ	ə l j eː k ʈ r oː l aː ɪ ʈ
    عزا	ʕ ɪ z ɑː
    آنا	ɑː n ɑː
    پسندیدہ	p ʊ s n d̪ iː d̪ ə
    ریڈ	r eː d̪
    مظالم	m ʊ z ɑː l ɪ m
    تبدیلی	t̪ ʊ b d̪ iː l iː
    بااثر	b ɑː ʔ ʊ s ɾ
    میٹابولائز	m eː ʈ ɑː b oː l aː ɪ z
    پرجوش	p ʊ r d͡ʒ oː ʃ
    کارکردگی	k ɑː r k ʊ r d̪ ɡ iː
    امام	ɪ m ɑː m
    اڈمیرل	ə d̪ m iː r l
    ماچٹ	m ɑː t͡ʃ ʈ
    یونیسیف	j uː n iː s iː f
    کھلاڑی	kʰ l ɑː ɽ iː
    وبائی	ʋ ʊ b aː ɪ
    نمائند	n ʊ m aː ɪ n d̪
    جی	d͡ʒ iː
    ابوغریب	ə b ʊ ɣ r iː b
    ماریشیس	m ɑː r iː ʃ iː s
    متعلق	m ʊ t̪ ʕ ʊ l ɪ q
    قابلیت	q ɑː b l iː t̪
    اسپیشلسٹ	ə s p eː ʃ l ɪ s ʈ
    ابلاغ	ə b l ɑː ɣ
    ثانوی	θ ɑː n ʋ iː
    ٹرانزیشنل	ʈ r ɑː n z iː ʃ n ʊ l
    لکژری	l ʊ k z ʊ r iː
    ندیو	n ʊ d̪ iː ʋ
    گھنٹا	ɡʱ ʊ n ʈ ɑː
    فرزند	f ʊ r z ʊ n d̪
    اسپیکٹرم	ə s p eː k ʈ r ʊ m
    سداسیوپیٹ	s ʊ d̪ ɑː s iː ʋ p eː ʈ
    سیشنس	s eː ʃ n s
    نبھانے	n ʊ bʱ ɑː n eː
    اسٹائسٹکس	ə s ʈ aː ɪ s ʈ k s
    تیکھا	t̪ eː kʰ ɑː
    تاریخی	t̪ ɑː r ɪ x iː
    سنوار	s ʊ n ʋ ɑː r
    دوستانہ	d̪ ʊ s t̪ ɑː n ə
    گرما	ɡ ʊ r m ɑː
    لحاظ	l ʊ ɦ ɑː z
    شجرکاری	ʃ ʊ d͡ʒ r k ɑː r iː
    نے	n eː
    پیٹ	p eː ʈ
    پیاس	p j ɑː s
    پتلا	p ʊ t̪ l ɑː
    بادامی	b ɑː d̪ ɑː m iː
مڈبھیڑ	m ʊ d̪ bʱ iː ɽ
صرفہ	s ʊ ɾ f ɑː
رواداری	ɾ ʋ ɑː d̪ ɑː ɾ iː
کوتلماں	k oː t̪ ʊ l m ɑː n
ذرا	z ɪ ɾ ɑː
ریچھ	ɾ eː t͡ʃʰ
یات	j ɑː t̪
ہچکنا	ɦ ʊ t͡ʃ k n ɑː
اسٹائسٹکس	ɪ s ʈ ɑː ɪ s ʈ k s
دلچسپی	d̪ ɪ l t͡ʃ ʊ s p iː
موٹر	m oː ʈ ɾ
جادھوپور	d͡ʒ ɑː d̪ʱ oː p ʊ ɾ
فالکن	f ɑː l k ʊ n
وفد	ʋ ʊ f d̪
ھما	ɦ m ɑː
استاد	ʊ s t̪ ɑː d̪
آرڈر	ɑː ɾ ʈ ɾ
ارتکاب	ɪ ɾ t̪ k ɑː b
آٹھواں	ɑː ʈʰ ʋ ɑː n
کودانڈارام	k oː d̪ ɑː n ʈ ɑː ɾ ɑː m
ڈپارٹمنٹ	ʈ p ɑː ɾ ʈ m ʊ n ʈ
رعیتوبازار	ɾ ʕ j ɪ t̪ oː b ɑː z ɑː ɾ
شیوسینا	ʃ iː ʋ s iː n ɑː
متواتر	m ʊ t̪ ʋ ɑː t̪ ɾ
نورانی	n ʊ ɾ ɑː n iː
فنڈ	f ʊ n ʈ
مہنت	m ʊ ɦ n ʈ
ابوغریب	ɑː b ʊ ɣ ɾ iː b
ریکارڈس	ɾ eː k ɑː ɾ ʈ s
تحصیل	t̪ ɦ ʊ s iː l
شوٹنگ	ʃ oː ʈ ɪ ŋ
کریم	k ɾ iː m
ادب	ɪ d̪ b
ناتھولا	n ɑː t̪ʱ oː l ɑː
سینا	s iː n ɑː
بلے	b ʊ l eː
دھاندل	d̪ʱ ɑː n d̪ ʊ l
صحابہ	s ʊ ɦ ɑː b ɑː
ولتھاٹی	ʋ ʊ l t̪ʱ ɑː ʈ iː
مصروف	m ʊ s ɾ ʊ f
زاید	z ɑː j ɪ d̪
رحمت	ɾ ɪ ɦ m ʌ t̪
آغوش	ɑː ɣ oː ʃ
کوششیں	k oː ʃ ɪ ʃ ẽː
نقلی	n ɪ q l iː
چنانچہ	t͡ʃ ʊ n ɑː n t͡ʃ ɑː
ناکامی	n ɑː k ɑː m iː
برتر	b ɪ ɾ t̪ ɾ
کاشف	k ɑː ʃ f
ٹورسٹ	ʈ ɔː ɾ s ʈ
مند	m ʊ n d
نشر	n ʌ ʃ r
دھوم	d̪ʱ uː m
کنٹیشور	k ʌ n ʈ iː ʃ ɔː r
ں	ɳ
نیاک	n iː ɑː k
داستان	d ɑː s t̪ ɑː n
قرعہ	q ʊ r ʌ ʕ ɑː
کونکنی	k uː n k n iː
انوپ	ɑː n uː p
کے	k eː
خصوصا	x ʊ s uː s ɑː
انجانا	ɑː n d͡ʒ ɑː n ɑː
اسکواڈ	ɑː s k uː ɑː d̪
موسیقی	m uː s iː q iː
قابل	q ɑː b ɪ l
پٹول	p ʈ oː l
قدرت	q ʊ d ɾ ɑː t̪
گولہ	ɡ oː l ɑː
ٹرانزیشنل	ʈ r ɑː n z iː ʃ ʌ n l
فوری	f ɔː r iː
سلوک	s ʊ l uː k
سورج	s uː r d͡ʒ
ہلڑ	ɦ ʊ l ɽ
جمیعتہ	d͡ʒ ʊ m iː ʕ ɑː t̪ ɑː
برعکس	b ɾ ʌ ʕ k s
مسٹالا	m ʊ s ʈ ɑː l ɑː
رہنا	r ɛː n ɑː
کمیشن	k ʌ m iː ʃ ʌ n
کشیدہ	k ʌ ʃ iː d̪ ɑː
ہیرو	ɦ iː r uː
مکین	m ʌ k iː n
احتمال	ɑː ɦ t̪ ɪ m ɑː l
ٹیوٹ	ʈ iː uː ʈ
سربیائی	s ʊ r b iː ɑː iː
پیٹ	p eː ʈ
چاول	t͡ʃ ɑː ʋ ʊ l
جنوری	d͡ʒ ʌ n uː r iː
بھنڈاری	bʱ ʊ n ʈʰ ɑː r iː
دلیل	d ɪ l iː l
دیو	d eː ʋ
کمیونٹی	k ʌ m j uː n ɪ ʈ iː
تبدیلی	t̪ ʌ b d̪ iː l iː
چارجس	t͡ʃ ɑː r d͡ʒ ɪ s
کنٹراکٹر	k ʌ n ʈ r ɑː k ʈ ʌ r
فصل	f ʌ s l
روپوش	r uː p oː ʃ
پورہ	p uː r ɑː
گولی	ɡ oː l iː
لاکھ	l ɑː kʰ

    نیم	n iː m
    شری	ʃ ɾ iː
    نقشہ	n ʌ k ʃ ɑː
    کیئر	k iː ɛ ɾ
    لئے	l ɛː
    ٹیکساس	ʈ iː k s ɑː s
    بوتھا	b oː t̪ʰ ɑː
    میز	m iː z
    ون	ʋ ʊ n
    منسلک	m ʊ n s ʊ l k
    مالیت	m ɑː l iː t̪
    عمرہ	ʕ ʊ m ɾ ɑː
    شہد	ʃ ɛː d̪
    سوار	s ʋ ɑː ɾ
    صحافتی	s ʊ h ɑː f t̪ iː
    بگاڈیا	b ʊ g ɑː ɖ iː ɑː
    خسر	x ʊ s ɾ
    تکنیکی	t̪ ʌ k n iː k iː
    سینکڑا	s eː n k ɽ ɑː
    ازاں	ɑː z ɑː n
    طبقات	ʈ ɑː b q ɑː t̪
    پوچیا	p oː t͡ʃ iː ɑː
    یوگیتا	j oː g iː t̪ ɑː
    حافظ	ħ ɑː f ɪ z
    چھتیس	t͡ʃʰ ʈ iː s
    آرام	ɑː ɾ ɑː m
    ترملگیری	t̪ ɾ m ʊ l g iː ɾ iː
    بااثر	b ɑː ʔ s ɛ ɾ
    جوڑ	d͡ʒ oː ɽ
    فیاض	f j ɑː z
    ضلاع	z ʊ l ɑː ʕ
    اعتماد	ɪ ʔ t̪ ɪ m ɑː d̪
    سداسیوپیٹ	s ʊ d ɑː s j oː p iː ʈ
    راجو	ɾ ɑː d͡ʒ oː
    النظر	ʔ ʊ l n ʊ z ɾ
    سائمن	s ɑː ɪ m ʊ n
    ناکامی	n ɑː k ɑː m iː
    الارض	ʔ ʊ l ɑː ɾ z
    ادھنا	ʔ ʊ d̪ʱ n ɑː
    پیام	p j ɑː m
    ٹورنمنٹ	ʈ oː ɾ n ʊ m ʊ n ʈ
    غیرموسمی	ɣ ɛː ɾ m oː s m iː
    وسلم	ʋ ʊ s l ʊ m
    اسپاٹ	ɪ s p ɑː ʈ
    چنی	t͡ʃ ʊ n iː
    فراخ۔دل	f ɾ ɑː x d ɪ l
    یومی	j oː m iː
    ایہود	ɪ j ɑː h ʊ d̪
    گرفتاری	ɡ ɾ ɪ f t̪ ɑː ɾ iː
    حقوق	ħ ʊ q uː q

    عہدہ	ʕ ɛː d̪ ɑː
    دکھانا	d̪ ɪ kʰ ɑː n ɑː
    معیشت	m ʕ eː ʃ t̪
    الداخلہ	ʔ ɛː l d̪ ɑː x l ɑː
    سونگھ	s uː ŋ ɦ
    رومس	ɾ uː m s
    دھل	d̪ ɦ ɛː l
    پینل	p eː n l
    بلین	b ɛː l iː n
    اکابر	ʔ ɑː k ɑː b ɛː ɾ
    مکل	m ʊ k l
    فیڈرر	f eː d̪ ɛː ɾ ɾ
    ریڈ	ɾ eː d̪
    ششی	ʃ ɪ ʃ iː
    خواہشمند	x ʋ ɑː ɦ ɪ ʃ m ɛː n d̪
    اینٹی	ʔ eː n ʈ iː
    نذرآتش	n ɛː z ɾ ɑː t̪ ɪ ʃ
    کاٹ	k ɑː ʈ
    بیک	b eː k
    کیابس	k j ɑː b s
    رنڈی	ɾ ɛː n ɖ iː
    انجنئیر	ɪ n d͡ʒ ɪ n ɪː ɾ
    سنور	s ɪ n ʋ ɔː ɾ
    العبیدی	ʔ ɛː l ʕ ɛː b iː d̪ iː
    حرف	ɦ ɛː ɾ f
    کے	k eː
    کھانا	kʰ ɑː n ɑː
    برف	b ɛː ɾ f
    موجھی	m ʋ oː d͡ʒ ɦ iː
    ہلاکت	ɦ ɛː l ɑː k t̪
    انسیت	ɪ n s iː t̪
    حامدالاحمر	ɦ ɑː m ɪ d̪ ʔ ɑː l ɑː ɦ m ɛː ɾ
    دینی	d̪ iː n iː
    محمد	m ʊ h ɑː m m ɛː d̪
    انگلانگ	ɪ ŋ g l ɑː ŋ g
    الہی	ʔ ɛː l ɦ iː
    شیطان	ʃ eː t̪ ɑː n
    نیننس	n eː n ɪ n s
    سواری	s ʋ ɑː ɾ iː
    آغوش	ɑː ɣ ʋ oː ʃ
    موڈ	m oː d̪
    بتایاکہ	b ɪ t̪ ɑː j ɑː k ɛː
    باضابطہ	b ɑː z ɑː b ɪ t̪ ɦ ɑː
    کمپٹرولر	k ʌ m p j uː t̪ ɛː ɾ oː l ɛː ɾ
    چاٹنا	t͡ʃ ɑː ʈ n ɑː
    سلیکٹر	s ɛː l ɪ k t̪ ɛː ɾ
    پھیلاؤ	pʰ eː l ɑː ʊ
    ٹھنڈا	ʈʰ ʊ n ɖ ɑː
    منان	m ʊ n ɑː n
    ارکنساس	ɑː ɾ k ə n s ɑː s
مکین	m ə k iː n
سینکڑوں	s eː n k ə ɽ oː n
حیاتیات	ɦ j aː t̪ iː j aː t̪
انڈر	ə n ɖ ə ɾ
اسٹیونس	ə s ʈ iː ʋ oː n s
طلبہ	ʈ ə l b ə ɦ
واٹر	ʋ aː ʈ ə ɾ
چوم	t͡ʃ oː m
شداد	ʃ ə d aː d̪
عاشق	ʕ aː ʃ ɪ q
پرابین	p ə ɾ aː b iː n
مربع	m ə ɾ b ɑː ʕ
کمبلے	k ə m b l eː
برن	b ə ɾ n
کفایتی	k ə f aː j t̪ iː
ظہیرآباد	z ə ɦ iː ɾ aː b aː d̪
معمول	m ʕ ə m uː l
مئی	m eː ɪ
اختیارکردہ	ə x t̪ iː j aː ɾ k ə ɾ d̪ ə ɦ
معلنہ	m ʕ ə l ə n ə ɦ
یورانیم	j ʊ ɾ aː n iː m
پھیلاؤ	pʰ eː l aː oː
ازم	ə z m
انہ	ə n ɦ
اخوت	ə x ʋ oː t̪
شاعر	ʃ aː ʕ ɪ ɾ
ڈیولس	ɖ iː oː l s
سوا	s ʋ aː
گارڈیولا	ɡ aː ɽ ɖ iː oː l aː
منصور	m ə n s ʊ ɾ
افتتاح	ə f t̪ t̪ ɑː ɦ
کوہ	k oː ɦ
غداری	ɣ ə d̪ aː ɾ iː
دھاندلی	d̪ʱ aː n d̪ l iː
بکس	b ə k s
اسرائیل	ə s ɾ aː ɪ l
مایہ	m aː j ɦ
موظف	m ʊ z ə f
شیوشنکر	ʃ iː ʋ ʃ ə n k ə ɾ
ڈیویژنل	ɖ iː ʋ iː ʒ n l
شان	ʃ aː n
نکاح	n ɪ k aː ɦ
ابوعبدالرحمن	ə b ʊ ʕ ə b d̪ ə l ɾ ɑː ɦ m ə n
واریرس	ʋ aː ɾ iː ɾ s
استثنی	ə s t̪ ɪ s n iː
مناسبت	m ə n aː s b ə t̪
ممنوعہ	m ə m n oː ʕ ə ɦ
واقفیت	ʋ aː q f iː t̪
غیرضروری	ɣ eː ɾ z ə ɾ uː ɾ iː
نوٹس	n oː ʈ s

    امام	ɪ m ɑː m
    کا	k ɑː
    سنجائے	s ʊ n d͡ʒ ɑː ɪ j eː
    اسپانچ	ɪ s p ɑː n t͡ʃ
    کاٹ	k ɑː ʈ
    اثاثہ	ɪ s ɑː s ɑː
    جانور	d͡ʒ ɑː n ʋ ə ɾ
    دیواستھانم	d̪ eː ʋ ɑː s t̪ʰ ɑː n ə m
    کمپٹرولر	k ʌ m p j uː t̪ ə ɾ oʊ l ə ɾ
    فورا	f ʊ ɾ ɑː
    اتم	ɪ t̪ ə m
    سیکڑوں	s iː k ə ɾ ʊ n
    جنیشور	d͡ʒ ə n iː ʃ ʊ ɾ
    مکواوگر	m ʌ k ʋ ɑː ʋ ɡ ə ɾ
    اصغر	ɪ s ɣ ə ɾ
    جارحانہ	d͡ʒ ɑː ɾ ɦ ɑː n ɑː
    بورڈس	b ɔː ɾ d̪ s
    پلانٹ	p l ɑː n ʈ
    نصبین	n ə s b iː n
    بھال	bʱ ɑː l
    اورمعیاری	ɔː ɾ m ʌ ɪ j ɑː ɾ iː
    اودھاؤ	ɔː d̪ʱ ɑː ʊ
    نیاک	n iː ɑː k
    مکرجی	m ʌ k ɾ d͡ʒ iː
    مکتب	m ʌ k t̪ ə b
    عینی	ʕ eː n iː
    لحاظ	l ɪ ɦ ɑː z
    بشیر	b ə ʃ iː ɾ
    شعر	ʃ ʊ ɾ
    انتقال	ɪ n t̪ iː q ɑː l
    ایڈس	eɪ d̪ s
    سہیل	s ə ɦ iː l
    نان	n ɑː n
    اکثریت	ʌ k s ʊ ɾ iː t̪
    واٹر	ʋ ɑː ʈ ə ɾ
    جاہی	d͡ʒ ɑː ɦ iː
    صد	s ʊ d
    معلم	m ʊ ʕ ə l ɪ m
    شہلا	ʃ ə ɦ l ɑː
    کٹرپسند	k ʈ ə ɾ p s ʊ n d̪
    بہنا	b ə ɦ n ɑː
    تھیراپی	t̪ʰ eː ɾ ɑː p iː
    مدینہ	m ə d̪ iː n ɑː
    بہادر	b ə ɦ ɑː d̪ ə ɾ
    خاصکر	x ɑː s k ə ɾ
    رامو	ɾ ɑː m ʊ
    آمریت	ɑː m ɾ iː t̪
    امتحان	ɪ m t̪ ɪ ɦ ɑː n
    یافتہ	j ɑː f t̪ ɑː
    لاگو	l ɑː ɡ ʊ

    نکسیر	n ɪ k s ɪ ə ɾ
    مچھرکش	m ʊ t͡ʃʰ ɾ k ɪ ʃ
    پرجا	p ɛ ɾ d͡ʒ ɑː
    در	d ɑː ɾ
    سلیکٹر	s ʊ l iː k ʈ ɛ ɾ
    بے۔چین	b eː ʧ eː n
    مایوس۔کن	m aː j oː s k ʊ n
    واڑی	ʋ aː ɽ iː
    بجائے	b ʊ d͡ʒ aː ɪ ə
    زبان	z ʊ b aː n
    علامت	ʕ ʊ l aː m ʌ t
    مہیب	m ʊ h iː b
    تاریک	t aː r iː k
    خودمحتار	x ʊ d m ʊ h t aː ɾ
    ٹریژری	ʈ r iː ʒ ɛ r iː
    ناظم	n aː z ʌ m
    موہنی	m oː h n iː
    پراڈکٹ	p ɾ aː ɖ ʌ k ʈ
    بیٹھ	b eː ʈʰ
    دھرنہ	dʱ ʊ r n ʌ
    مہیندرا	m ʊ h iː n d ɾ aː
    ڈاکٹر	ɖ aː k ʈ ɛ ɾ
    سنجیدہ	s ʊ n d͡ʒ iː d ʌ
    بھکت	bʱ ʌ k t
    موسیقی	m oː s iː q iː
    خونریز	x ʊ n r iː z
    شیپ	ʃ eː p
    کلکٹر	k ʊ l k ʈ ɛ ɾ
    آج	aː d͡ʒ
    گولہ	ɡ oː l ʌ
    پیاس	p j aː s
    کاج	k aː d͡ʒ
    دستاویز	d ʊ s t aː ʋ iː z
    پےنٹ	p eː n ʈ
    مہاراشٹر	m ʊ h aː r aː ʃ ʈ ɛ ɾ
    نورانی	n ʊ r aː n iː
    مقدر	m ʊ q d ɾ
    پدماناتھن	p ʊ d m aː n aː tʰ n
    الیکشن	ʌ l iː k ʃ ʌ n
    سنجها	s ʊ n d͡ʒ ʌ
    ملکہ	m ʊ l k ʌ
    گرما	ɡ ɾ m aː
    پرندہ	p ɛ ɾ n d ʌ
    ماتحت	m aː tʰ ʌ t
    مباحثہ	m ʊ b aː h ʌ tʰ ʌ
    سمجھ	s ʊ m d͡ʒʱ
    ترملگیری	t ɛ r m ʊ l g iː r iː
    مروڑ	m ɛ ɾ ʋ ɔː ɽ
    مہنت	m ʊ h n ʌ t
    چھتیس	t͡ʃʰ ʌ t iː s

    ایونٹ	ɑː j uː n ʈ
    سمن	s ʊ m ə n
    اختتام۔پزیر	ɑː x t̪ t̪ ɑː m p ə z iː ɾ
    خلل	x ʊ l l
    پوزم	p oː z ə m
    نبردآزما	n ə b ɾ d̪ ɑː z m ɑː
    سلیور	s ʊ l j ɔː ɾ
    آمریت	ɑː m ɾ iː t̪
    مسٹرسنہا	m ʊ s ʈ ɾ ə s n ə ɦ ɑː
    نبی	n ə b iː
    بیمار	b eː m ɑː ɾ
    گجنی	ɡ ʊ d͡ʒ n iː
    مربع	m ʊ ɾ b ɑː
    انگلستان	ɪ ŋ ɡ l ɪ s t̪ ɑː n
    ٹرینس	ʈ ɾ eː n s
    چھینک	t͡ʃʰ iː n k
    طیرانگاہ	ʈ iː ɾ ɑː n ɡ ɑː ɦ
    ناراض	n ɑː ɾ ɑː z
    سندھو	s ɪ n d̪ʱ uː
    پرستش	p ə ɾ ə s t̪ ɪ ʃ
    مکین	m ʊ k iː n
    اولیا	ɑː ʋ l iː ɑː
    کاج	k ɑː d͡ʒ
    سنجیدگی	s ʊ n d͡ʒ iː d̪ ɡ iː
    مشرق	m ɪ ʃ ɾ ɪ q
    سوپراسٹار	s uː p ɾ ɑː s ʈ ɑː ɾ
    معاہدہ	m ʊ ɑː ɦ ɪ d̪ ɑː
    ناٹ	n ɑː ʈ
    چرخہ	t͡ʃ ɪ ɾ x ə
    سشما	s ʊ ʃ m ɑː
    سرزمین	s ʊ ɾ z ə m iː n
    چھان	t͡ʃʰ ɑː n
    بہیرہ	b ə ɦ eː ɾ ə
    فروری	f ə ɾ ʋ ə ɾ iː
    یکساں	j ə k s ɑː n
    سندر	s ʊ n d̪ ɾ
    طبقہ	ʈ ə b q ə
    واقعاتی	ʋ ɑː q eː ɑː t̪ iː
    وظیفدار	ʋ ʊ z iː f d̪ ɑː ɾ
    شہد	ʃ ə ɦ d̪
    مقدر	m ʊ q d̪ ɑː ɾ
    آواز	ɑː ʋ ɑː z
    رامچندر	ɾ ɑː m t͡ʃ ʊ n d̪ ɾ
    کالجس	k ɑː l d͡ʒ ə s
    مرکندہ	m ʊ ɾ k ə n d̪ ə
    بےحیائی	b eː ɦ j ɑː iː
    یونائیٹڈ	j uː n ɑː iː ʈ ɪ d̪
    اناہزارے	ɪ n ɑː ɦ z ɑː ɾ eː
    اسکینڈلس	ə s k iː n d̪ ə l s
    بریہ	b ə ɾ j ə

    راجیم	r ɑː d͡ʒ iː m
    جنم	d͡ʒ ə n m
    ایرلائینس	ɛː r l aɪ n s
    کچرہلز	k ʊ t͡ʃ r ə h l z
    ویٹ	ʋ eɪ t
    ترنمول	t ə r n m uː l
    غیرمنافع	ɣ ɛː r m ə n ɑː f ɛ
    کپڑا	k ə p ɽ ɑː
    سنگھ	s ə ŋ ɦ
    افریقہ	ɑː f r iː q ɑː
    آفت	ɑː f t
    پیکلس	p eɪ k l s
    اوسو	ɔː s o
    مذاکرہ	m ʊ z ɑː k ə r ɑː
    میڑچل	m eː ɽ t͡ʃ l
    منسٹرس	m ə n s t ə r s
    کاٹ	k ɑː ʈ
    متوجہ	m ʊ t ʋ o d͡ʒ ɑː
    توصیف	t ʋ o s iː f
    قطب	q ʊ t̪ b
    اسپائس	ɪ s p aɪ s
    پانچوں	p ɑː n t͡ʃ o
    فرزند	f ə r z ə n d
    وشنو	ʋ ɪ ʃ n o
    کھلواڑ	kʰ ə l ʋ ɑː ɽ
    اخراجات	ɑː x r ɑː d͡ʒ ɑː t
    سبب	s ə b b
    مسٹرڈ	m ʊ s t ə r d
    چکرورتی	t͡ʃ ə k r ʊ r t iː
    شنید	ʃ ə n iː d
    دندنا	d ə n d ə n ɑː
    فہد	f ə h d
    بے۔چین	b eː t͡ʃ eɪ n
    یوسی	j oʊ s iː
    آبادی	ɑː b ɑː d iː
    خریدار	x ə r iː d ɑː r
    تلقین	t ə l q iː n
    فریدآباد	f ə r iː d ɑː b ɑː d
    بایزید	b aɪ z iː d
    زکوا	z ə k ʋ ɑː
    دھاندلی	d̪ʱ ɑː n d ə l iː
    ہدیۂ	ɦ ə d iː ə
    ریحان	r eɪ h ɑː n
    چوگنا	t͡ʃ o ɡ n ɑː
    ذ	z
    تتلی	t ə t l iː
    بلی	b ə l iː
    چنگال	t͡ʃ ə ŋ g ɑː l
    تیسری	t eː s r iː
    فلک۔نما	f ə l k n ə m ɑː
بندیل	b ə n d iː l
تحقیقی	t̪ ə ɦ ə q iː q iː
اپدهان	ə p d̪ e ɦ ɑː n
شائق	ʃ ɑː ɪ q
سہواس	s ə ɦ ʋ ɑː s
گیلانی	ɡ iː l ɑː n iː
مالک	m ɑː l ə k
شرط	ʃ ə ɾ t̪
ٹیکسی	ʈ iː k s iː
ہنس	ɦ ə n s
استوار	ə s t̪ ʋ ɑː ɾ
قاعدہ	q ɑː ʕ iː d̪ ə
کار	k ɑː ɾ
ساڑی	s ɑː ɽ iː
ڈاکٹر	ɖ ɑː k ʈ ə ɾ
تخلیہ	t̪ ə x l iː ɦ ə
ہانگ	ɦ ɑː ŋ ɡ
بہاؤالدین	b ə ɦ ɑː ʊ ə l d iː n
فالکن	f ɑː l k ə n
سکتہ	s ə k t̪ ə
ڈومور	ɖ ʋ oː m ɔː ɾ
ڈر	ɖ ə ɾ
تصویر	t̪ ə s ʋ iː ɾ
عروس	ʕ ʊ ɾ ʊ s
ہکا	ɦ ə k ɑː
ترقی	t̪ ə ɾ q iː
سارا	s ɑː ɾ ɑː
اوراد	ɔː ɾ ɑː d̪
خازن	x ɑː z ə n
روایاتی	ɾ ʋ ɑː j ɑː t̪ iː
امریکا	ɑː m ɾ iː k ɑː
انڈر۔پاس	ɪ n ɖ ə ɾ p ɑː s
ارسطو	ɑː ɾ s ʈ ʋ
خروش	x ɾ ʊ ʃ
دادا	d ɑː d ɑː
رضوی	ɾ ɪ z ʋ iː
مدعوئین	m ʊ d ʕ ʋ ɪː n
مفتی	m ʊ f t̪ iː
ریکارڈز	ɾ eɪ k ɑː ɾ ɖ z
شوقین	ʃ ʊ q iː n
راجیش	ɾ ɑː d͡ʒ iː ʃ
غیرمحفوظ	ɣ ɛː ɾ m ɦ ʊ f ʊ z
خالد	x ɑː l ɪ d̪
مصر	m ɪ s ɾ
ناصرت	n ɑː s ɪ ɾ ə t̪
بینچ	b iː n t͡ʃ
شیواجی	ʃ iː ʋ ɑː d͡ʒ iː
کاٹ	k ɑː ʈ
ناظرہ	n ɑː z ɪ ɾ ə
رامچندر	ɾ ɑː m t͡ʃ ʊ n d̪ ɾ

    شام	ʃ ɑː m
    خاصے	x ɑː s e
    باشندہ	b ɑː ʃ n d ə
    اوز	oː z
    مقررہ	m ʊ q ɾ ɑː ɾ ə
    چیمپین	t͡ʃ iː m p iː n
    اناج	ɑː n ɑː d͡ʒ
    مہارت	m ə ɦ ɑː ɾ ə t̪
    رائلس	ɾ ɑː ɪ l s
    استثنی	ɪ s t̪ ɪ s n ɑː iː
    غیرمعروف	ɣ ɪ ɾ m ɑː ɾ uː f
    جنم	d͡ʒ ə n m
    مر	m ə ɾ
    راما	ɾ ɑː m ɑː
    گمبھی	ɡ ə m bʱ iː
    پانڈے	p ɑː n ʈ e
    سرزنش	s ə ɾ z n ɪ ʃ
    ویرنمنٹ	ʋ iː ɾ n ə m ə n t̪
    پراڈکٹس	p ɾ ɑː ʈ k ʈ s
    غزوۂ	ɣ ə z ʋ ə
    سوٹ	s uː ʈ
    دور	d̪ uː ɾ
    رنگاریڈی	ɾ ə ŋ g ɑː ɾ iː d̪ iː
    تہائی	t̪ ə ɦ ɑː iː
    مقتول	m ʊ q t̪ uː l
    گود	ɡ uː d̪
    چوڑا	t͡ʃ ʊ ɽ ɑː
    میٹنگ	m iː ʈ ɪ ŋ ɡ
    ناگ	n ɑː ɡ
    پرمیشور	p ɾ ə m iː ʃ ɔː ɾ
    ابن	ə b n
    توسیعی	t̪ ʊ s iː ʔ iː
    پاؤڈر	p ɑː ʊ ʈ ə ɾ
    ایشیائی	ɑː iː ʃ iː ɑː iː
    لٹیرا	l ʊ ʈ iː ɾ ɑː
    بتدریج	b ə t̪ d̪ ɾ iː d͡ʒ
    مجیب	m ʊ d͡ʒ iː b
    ہیڈکوارٹر	ɦ iː ʈ k ʋ ɑː ɾ ʈ ə ɾ
    یوگانڈا	j ʊ ɡ ɑː n ʈ ɑː
    سل	s ə l
    بادبان	b ɑː d̪ b ɑː n
    پردیش	p ɾ ə d̪ iː ʃ
    کہاکہ	k ə ɦ ɑː k ə
    شرکا	ʃ ə ɾ k ɑː
    صالح	s ɑː l ɪ ɦ
    نکاح	n ɪ k ɑː ɦ
    فیالوقت	f iː ɑː l ʋ ʊ q t̪
    فائدہ	f ɑː ɪ d̪ ə
    چوراستہ	t͡ʃ ʊ ɾ ɑː s t̪ ə
    بڑھتا	b ə ɽ ʈ ɑː

    وینیو	ʋ eɪ n iː uː
    سیکریٹریٹ	s iː k r iː ʈ ə r iː ʈ
    پانڈیچری	p ɑː n ɖ iː t͡ʃ ə r iː
    الزہرہ	ʌ l z ə h r ə
    چوکا	t͡ʃ oʊ k ə
    آندھرائی	ɑː n d̪ʱ ə r ɑː iː
    پوٹےشیم	p oʊ ʈ eɪ ʃ iː m
    آیئنا	ɑː iː ə n ə
    مقصدبراری	m ʊ k s ə d b ə r ɑː r iː
    ناساز	n ɑː s ɑː z
    جوں	d͡ʒ oʊ n
    بشکل	b ʊ ʃ k ə l
    عطر	ʕ ɪ t̪ r
    الم	ʌ l m
    ہجوم	h ə d͡ʒ oʊ m
    مہیندرا	m ə h iː n d r ɑː
    سرسوتی	s ə r s ʊ t iː
    سمکھ	s ə m kʰ
    کھڑا	kʰ ə ɽ ɑː
    ٹھیس	ʈʰ iː s
    یت	j ə t
    چاول	t͡ʃ ɑː ʋ ə l
    مسٹرسنہا	m ɪ s ʈ ə r s n ə h ɑː
    متجاوز	m ʊ t̪ d͡ʒ ɑː ʋ ə z
    کارخانہ	k ɑː r x ɑː n ə
    جوڑا	d͡ʒ oʊ ɽ ɑː
    بےبس	b eɪ b ə s
    ایڈس	ɑː iː d̪ s
    آواز	ɑː ʋ ɑː z
    پٹیل	p ʈ iː l
    ٹورنمنٹ	ʈ ɔː r n m ə n ʈ
    نظریہ	n ə z ə r iː ə
    دلائی	d ə l ɑː iː
    مفتی	m ʊ f t iː
    رنجن	r ə n d͡ʒ ə n
    گھیرنے	ɡʱ iː r n eɪ
    سکھشا	s ə kʰ ʃ ɑː
    گندا	ɡ ʊ n d ɑː
    وزیرداخلہ	ʋ ə z iː r d ɑː x l ə
    ڈیولپمنٹ	ɖ iː oʊ l p m ə n ʈ
    سوامی	s ʊ ɑː m iː
    مکتب	m ʊ k t ə b
    نکال	n ɪ k ɑː l
    اڈے	ɑː ɖ eɪ
    موجھی	m oʊ d͡ʒʱ iː
    گفتگو	ɡ ʊ f t ɡ oʊ
    زراعت	z ə r ɑː ʕ ə t
    دھن	d̪ʱ ʊ n
    اجتماعی	ɑː d͡ʒ t ɪ m ɑː ʕ iː
    تخلیہ	t ə x l iː ə

    نجیب	n ə d͡ʒ iː b
    انتخابی	ɪ n t̪ ɪ x ɑː b iː
    آئے	ɑː ɪ ɛː
    مودی	m uː d iː
    نندی	n ə n d iː
    شائنی	ʃ ɑː ɪ n iː
    اپرادھی	ə p ɾ ɑː d̪ʱ iː
    فلک۔نما	f ɪ l k n ə m ɑː
    کودانڈارام	k uː d ɑː n ɖ ɑː ɾ ɑː m
    اڈے	ə ɖ ɛː
    ایذارسانی	ɛː ð ɑː ɾ s ɑː n iː
    قابض	q ɑː b z
    پلاٹس	p l ɑː ʈ s
    جاسوس	d͡ʒ ɑː s uː s
    گمبھیر	ɡ ʊ m bʱ iː ɾ
    دیواستھانم	d̪ eː ʋ ɑː s t̪ʰ ɑː n ə m
    اوقاف	ɔː q ɑː f
    منسٹرا	m ə n s ʈ ɾ ɑː
    رائےدہندگان	ɾ ɑː ɪ d̪ ə ɦ ə n d̪ ɡ ɑː n
    پل	p ə l
    شکوہ	ʃ ɪ k ʋ ə ɦ
    المسلمین	ʊ l m ʊ s l iː m iː n
    بےحد	b eː ɦ ə d̪
    بے۔چین	b eː t͡ʃ eː n
    راؤنڈر	ɾ ɑː ʊ n ɖ ə ɾ
    روپے	ɾ uː p eː
    ڈرین	ɖ ɾ iː n
    سائینس	s ɑː ɪ n s
    نان	n ɑː n
    نتجہ	n ə t̪ d͡ʒ ə ɦ
    کوچس	k oː t͡ʃ ə s
    اندر	ɪ n d̪ ə ɾ
    رامچندر	ɾ ɑː m t͡ʃ ə n d̪ ɾ ə
    کار	k ɑː ɾ
    بورن	b ɔː ɾ n
    ٹھیس	ʈʰ iː s
    نکسیر	n ɪ k s iː ɾ
    مصارف	m ʊ s ɑː ɾ ɪ f
    طاقتور	t̪ ɑː q t̪ ʋ ɔː ɾ
    ہلڑ	ɦ ə l ɽ
    واٹر	ʋ ɑː ʈ ə ɾ
    وینکٹ	ʋ eː n k ɪ ʈ
    عنقاد	ʕ ɪ n q ɑː d̪
    سیریز	s iː ɾ iː z
    ہڑتالی	ɦ ə ɽ t̪ ɑː l iː
    باون	b ɑː ʊ n
    پیٹرسن	p eː ʈ ə ɾ s ə n
    سائبرٹاورس	s ɑː ɪ b ə ɾ ʈ ɑː ʋ ə ɾ s
    توں	t̪ ʊ n
    پھیر	pʰ eː ɾ
