चपेटा	t͡ʃʌpʌʈʌ
क्रमागत	kʌɾʌmʌɡʌt
ठेक्‍का	ʈʰʌkʌkʌ
गृष्म	ɡʌɾɪʃʌm
उष्ण	uʂʌɳ
भाक्	bʱʌk
कुच्चे	kʌt͡ʃt͡ʃʌ
सद्‌गुरु	sʌdʌɡʌɾʌ
आइडल	ʌʌɪɖʌl
मदिरा	mʌdɪɾʌ
तड्प	tʌɖp
चस्मदिद	t͡ʃʌsmʌdɪd
छुरो	t͡ʃʌɾʌ
ख्याति	kʌjʌʈɪ
ठन्डा	ʈʰʌnɖʌ
आनुश्राविक	ʌʌnʌʃɾʌʌvɪk
द्वैपायन	dʌʌɪpʌʌjʌn
सिम्टा	sɪmʈʌ
हिमालचुली	ɦɪmʌʌlʌt͡ʃʌlɪ
चमचम	t͡ʃʌmt͡ʃʌm
रतन	ɾʌtʌn
टुङ्‍ना	ʈʌŋʌ
अप्रेशन	ʌpɾʌʃʌn
कठोरपन	kʌʈʰʌɾʌpʌn
टेलिस्कोप	ʈʌlɪskʌp
कुर्ची	kʌɾt͡ʃɪ
झोक्का	d͡zʌʌkʌ
बन्दीघर	bʌndɪɡʌɾ
ऐन	ʌɪn
पुकपाक	pʌkpʌk
मूर्ति	mʌʌɾtɪ
अकथनिय	ʌkʌtʰʌnɪj
धिक्कार	dʌɦɪkʌʌɾ
रामेश्वर	ɾʌʌmʌʃʌʋʌɾ
सराइ	sʌɾʌʌɪ
उल्लिखित	uʌlɪkʌɪt
परख	pʌɾʌkʌ
सायुज्य	sʌʌjʌd͡zʌj
किफाएति	kɪfʌʌʌɪtɪ
समर	sʌmʌɾ
तार्	tʌʌɾ
विदुर	ʋɪdʌɾ
जटित	d͡zʌʈɪt
गोप्यता	ɡʌʌpjʌtʌ
घरपरिवार	ɡʌɾpʌɾɪʋʌɾ
जातीय	d͡zʌʌtɪj
जलाम्मे	d͡zʌlʌʌmʌ
अनृतवादी	ʌnʌɾɪtʌʋʌʌdɪ
ला	lʌ
लोकप्रियता	lʌʌkpɾɪjʌtʌ
धरौटी	dʱ ə r ɔ ʈ i
र्‍याल	r j ɑ l
कसूरदार	k ə s u r d ɑ r
अडभङ्ग्याहा	ə ɖ bʱ ə ŋ j ɑ h ɑ
उत्तिस	u t̪ t̪ i s
सतबिउ	s ə t̪ ə b i u
खेरि	kʰ e r i
गबडू	g ə b ə ɖ u
प्रतिपद	p r ə t̪ i p ə d
ठेकेदार	ʈʰ e k e d ɑ r
कुँढ्	k ũ ɖʱ
चिम्टे	t͡ʃ i m ʈ e
आरक्षण	ɑ r ə kʃ ə n
बिसौनी	b i s ɔ u n i
फुट्	pʰ u ʈ
अगणनीय	ə g ə ɳ ə n i j
कर्णाली	k ə r ɳ ɑ l i
पचपच	p ə t͡ʃ p ə t͡ʃ
अल्पमत	ə l p ə m ə t̪
अरुन्धती	ə r u n dʱ ə t̪ i
कर्के	k ə r k e
पुरस्कार	p u r ə s k ɑ r
जग्गाजमिन	d͡ʒ ə g g ɑ d͡ʒ ə m i n
लताम	l ə t̪ ɑ m
आनन्दी	ɑ n ə n d i
आलोडन	ɑ l o ɖ ə n
अखानो	ə kʰ ɑ n o
छोप	t͡ʃʰ o p
आशाकारी	ɑ ʃ ɑ k ɑ r i
नपुङ्सक	n ə p u ŋ s ə k
योजना	j o d͡ʒ ə n ɑ
मतान्तर	m ə t̪ ɑ n t̪ ə r
देवेन्द्र	d e w e n d r ə
मरमरम्मत	m ə r m ə r m ə t̪
उखान	u kʰ ɑ n
विस्तार	w i s t̪ ɑ r
समवाय	s ə m ə w ɑ j
रोगब्याधी	r o g ə b j ɑ dʱ i
भाडा	bʱ ɑ ɖ ɑ
नागरिकता	n ɑ g ə r i k ə t̪ ɑ
बढीमालिका	b ə ɖʱ i m ɑ l i k ɑ
सहसेनानी	s ə h ə s e n ɑ n i
ईसाइ	i s ɑ i
कम्युनिष्‍ट	k ə m j u n i ʃ ʈ
चुकुल	t͡ʃ u k u l
हिचकिचाउ	ɦ i t͡ʃ k i t͡ʃ ɑ u
पिटिपिटी	p i ʈ i p i ʈ i
हृदय	ɦ r i d ə j
चनाखो	t͡ʃ ə n ɑ kʰ o
कम्बल	k ə m b ə l

    पिशाच	p i ɕ a ː t͡ʃ
बत्ताउ	b ʌ t̪ t̪ a ː u
नाइटो	n a ː i t̪ o
डल्लेँठो	ɖ ʌ l l e ː ʈʰ o
मुलुक	m u l u k
कल्पनीय	k ʌ l p n i j ʌ
टट्टाउ	ʈ ʌ ʈ ʌ ː u
हत्याहिंसा	ɦ ʌ t̪ j a ː ɦ i ː s a ː
हबल्दारी	ɦ ʌ b l d a ː r i ː
उपद्र्याहा	u p ʌ d r j a ː ɦ a ː
आमसञ्चार	a ː m s ʌ ɲ t͡ʃ a ː r
झोकी	d͡zʱ o k i ː
टाउको	ʈ a ː u k o
अरुचिकर	ʌ r u t͡ʃ i k ʌ r
थाम्	t̪ʰ a ː m
ख्यात	kʰ j a ː t̪
ग्वाँगे	ɡ w a ː ŋ ɡ e
जिल्लाराम	d͡ʒ i l l a ː r a ː m
स्याल्ल	s j a ː l l
डिपोट	ɖ i p o ʈ
अगणनीय	ʌ ɡ ʌ ɳ n i j ʌ
लहै	l ʌ ɦ a i
कवाडी	k ʌ w a ː ɖ i ː
नारायणपुर	n a ː r a ː j ʌ ɳ p u r
घामपानी	ɡʱ a ː m p a ː n i ː
जनशक्ति	d͡ʒ ʌ n ʃ ʌ k t̪ i
महिष	m ʌ ɦ i ʃ
सिर्क	s i r k
आदर	a ː d ʌ r
जङ्गे	d͡ʒ ʌ ŋ ɡ e
वहीँ	w ʌ ɦ i ː
झट्कार्	d͡zʱ ʌ ʈ k a ː r
बरु	b ʌ r u
तड्पडाउ	t̪ ʌ ɖ p ʌ ɖ a ː u
परिपाठ	p ʌ r i p a ː ʈʰ
ब्यानर	b j a ː n ʌ r
कठपाइले	k ʌ ʈʰ p a ː i l e
थाल्नी	t̪ʰ a ː l n i ː
धपेड्	dʱ ʌ p e ɖ
तार्	t̪ a ː r
लत्रिनु	l ʌ t̪ r i n u
अन्यथा	ʌ n j ʌ t̪ʰ a ː
उच्छेदन	u t͡ʃʰ e d ʌ n
झुल्के	d͡zʱ u l k e
फलैँचा	pʰ ʌ l a i ː t͡ʃ a ː
पजेरो	p ʌ d͡ʒ e r o
उतार	u t̪ a ː r
ख्याउ	kʰ j a ː u
गोतिया	ɡ o t̪ i j a ː
झुत्ती	d͡zʱ u t̪ t̪ i ː
जातपतित	ʤɑːt̪pət̪ɪt̪
फेचो	pʰeʧo
सम	səm
गौँठली	ɡɔ̃ʈʰliː
ऊर्ध्वमूल	uːrd̪ʱʋəmuːl
टम्माटम्मी	ʈəmmɑːʈəmmiː
आडिलो	ɑːɖɪlo
मलामी	məlɑːmiː
चौसट्ठीऔं	t͡ʃɔʊsʌʈʰiːɔ̃
सबार	səbɑːr
जुत्त्याउ	ʤʊt̪t̪jɑːʊ
फोकस	pʰoʊkəs
बराम	bərɑːm
रिसोर्ट	rɪsɔːrʈ
मन्थरा	mənt̪ʰərɑː
कुशासन	kʊʃɑːsən
अवधि	əʋəd̪ʱiː
पलट्ट	pəlʌʈʈ
मनोभावना	mənoʊbʱɑːʋnɑː
वृद्ध	ʋrɪd̪ʱ
मीठो	miːʈʰo
अतुलनीय	ət̪ʊləniːj
सिकाइ	sɪkɑːi
कौसी	kaʊsiː
बाइकार्बोनेट	bɑːikaːrboneʈ
डिसेम्बर	ɖɪsembər
गणना	ɡəɳənɑː
एस	es
बढ्	bəd̪ʱ
दस्तखत	d̪əst̪əkʰət̪
लत्र्याङ्ङ	lət̪rjɑːŋŋ
आल्मारी	ɑːlmɑːriː
साँघी	sɑ̃ːɡʱiː
जुरुक्क	ʤʊrukʰkʰ
कर्‌याम्म	kərjɑːmm
ल्याउ	ljɑːʊ
मीनपचास	miːnpəʧɑːs
कन्पारो	kənpɑːro
पूर्ति	puːrt̪iː
आख्यायक	ɑːkʰjɑːjək
इन्डिया	ɪnɖɪjɑː
उद्‌भावित	ʊd̪bʱɑːʋɪt̪
पितपित	pɪt̪əpɪt̪
थिमी	t̪ʰɪmiː
शुभ	ʃʊbʱ
आर्य	ɑːrj
घरपरिवार	ɡʱərəpərɪʋɑːr
खौवा	kʰɔʊʋɑː
पहल	pəʱəl
घडघडे	ɡʱəɖɖəɖe
गित	ɡ i t
चटपटे	t͡ʃ ʌ ʈ ʌ ʈ e
कम्युनिष्‍ट	k ʌ m j u n i ʂ ʈ
मढ्	m ʌ ɖʱ
गन्धालु	ɡ ʌ n d̪ʱ ä l u
अन्तर्त्वचा	ʌ n t̪ ʌ r t̪ w ʌ t͡ʃ ä
घिरघिर	ɡʱ i r ɡʱ i r
बाइकार्बोनेट	b ä i k ä r b o n e ʈ
डच	ɖ ʌ t͡ʃ
उल्लिखित	u l l i kʰ i t̪
जडौरी	d͡ʒ ʌ ɖ ʌ u r i
उपचारी	u p ʌ t͡ʃ ä r i
खल्लो	kʰ ʌ l l o
टुकटुकती	ʈ u k ʈ u k ʌ t̪ i
मेष	m e ʂ
खाम्	kʰ ä m
रेल्वे	r e l w e
बगली	b ʌ ɡ ʌ l i
वृत्तान्त	b r i t̪ t̪ ä n t̪
खसोखास	kʰ ʌ s o kʰ ä s
अधिवक्ता	ʌ d̪ʱ i b ʌ k t̪ ä
लहैलहै	l ʌ ɦ ä i l ʌ ɦ ä i
गौँठली	ɡ ʌ̃ ʈʰ l i
प्रिन्ट	p r i n ʈ
भरथरी	bʱ ʌ r ʌ t̪ʰ r i
पेन्टिङ	p e n ʈ i ŋ
उपनिवेशवाद	u p ʌ n i b e ʂ w ä d̪
महँगी	m ʌ ɦ ʌ̃ ɡ i
चपाती	t͡ʃ ʌ p ä t̪ i
सप्र्याक	s ʌ p r j ä k
तिब्बत	t̪ i b b ʌ t̪
क्यानभास	k j ä n bʱ ä s
लम्मि	l ʌ m m i
काँधि	k ä̃ d̪ʱ i
चटक	t͡ʃ ʌ ʈ ʌ k
आज	ä d͡z
फैसला	pʰ ä i s ʌ l ä
चिहिरि	t͡ʃ i ɦ i r i
गुठी	ɡ u ʈʰ i
उफ्र	u pʰ r
सिध्रा	s i d̪ʱ r ä
सङ्काय	s ʌ ŋ k ä j
कछार	k ʌ t͡ʃʰ ä r
लौखा	l ʌ u̯ kʰ ä
पीप	p i p
सन्ठी	s ʌ n ʈʰ i
गोरखनाथ	ɡ o r ʌ kʰ n ä ʈʰ
बिट	b i ʈ
सइस	s ʌ i s
जेता	d͡z e t̪ ä
गुठी	ɡ u ʈʰ i
वेदवाक्य	ʋ e d̪ ʋ a k j ə
आर्ज	ɑ r ɟ
जङ्गे	ɟ ə ŋ ɡ e
रल्लि	r ə l l i
अधमरो	ə d̪ʱ m ə r o
ऋकार	ɾ i k ɑ r
फारु	pʰ ɑ r u
वश	ʋ ə ʃ
आफन्त	ɑ pʰ n ə t̪
खैँच	kʰ ɛ̃ t͡ʃ
भाडा	bʱ ɑ ɖ ɑ
गडर्‌याङ्ङ	ɡ ə ɖ r j ɑ ŋ ŋ
उपयोगी	u p ə j o ɡ i
स्वर्ग	s ʋ ə r ɡ
उजराती	u ɟ r ɑ t̪ i
अल्पमत	ə l p m ə t̪
भरणपोषण	bʱ r ə n p o ʂ ə n
ओभाउ	o bʱ ɑ u
शंसोधन	ʃ ə n s o d̪ʱ ə n
विरही	ʋ i r ə ɦ i
प्रेसिडेन्ट	p r e s i ɖ e n ʈ
झिम्रिक्क	ɖʐ i m r i k k
कम्बल	k ə m b ə l
फट्ट	pʰ ə ʈ ʈ
मधौरु	m ə d̪ʱ o u r u
काङ्क्षित	k ɑ ŋ k ʂ i t̪
भुँडल्लो	bʱ ũ ɖ ə l l o
परख	p ə r ə kʰ
अखानो	ə kʰ ɑ n o
बलात्कार	b ə l ɑ t̪ k ɑ r
बुरुण्डी	b u r u ɳ ɖ i
बार्	b ɑ r
कल्पनीय	k ə l p n i j ə
चिन्	t͡ʃ i n
सत्याल	s ə t̪ j ɑ l
अदृश्य	ə d̪ r ɪ ʃ j ə
भत्कोस	bʱ ə t̪ k o s
बक्	b ə k
जर्कि	ɟ ə r k i
दङ्गा	d̪ ə ŋ ɡ ɑ
वायुसेना	ʋ ɑ j u s e n ɑ
र्‍याल	r j ɑ l
मुनामदन	m u n ɑ m ə d̪ ə n
उगाउ	u ɡ ɑ u
विशेषण	ʋ i ʃ e ʂ ə n
मनोविज्ञान	m ə n o ʋ i ɟ ɲ ɑ n
प्यारा	p j ɑ r ɑ
विश्राम	ʋ i ʃ r ɑ m
इकोसिस्टम	i k o s i s ʈ ə m
अल्पस्मृति	ʌ l p s m ɾ i t̪ i
हार्दिकता	ɦ ä r d̪ i k ʌ t̪ ä
मालश्री	m ä l ʃ r i
पसलवाला	p ʌ s ʌ l ʌ ʋ ä l ä
कौवाली	k ʌ̃ ʋ ä l i
दर्पण	d̪ ʌ r p ʌ n̪
कङ्गाली	k ʌ ŋ ɡ ä l i
अतुल	ʌ t̪ u l
गोस्वारी	ɡ o s ʋ ä r i
विबाह	ʋ i b ä ɦ
हाई-हाई	ɦ ä i - ɦ ä i
औताउ	ʌ̃ u t̪ ä u
पनौती	p ʌ n̪ ʌ̃ u t̪ i
छन्	t͡sʰ ʌ n
लेखक	l e kʰ ʌ k
उपचारी	u p t͡ʃ ä r i
कत्थक	k ʌ t̪ t̪ʰ ʌ k
चारखाने	t͡ʃ ä r kʰ ä n̪ e
माल्टा	m ä l ʈ ä
ऋचा	r i t͡ʃ ä
अल्पसंख्या	ʌ l p s ʌ̃ kʰ j ä
गुहार	ɡ u ɦ ä r
उनान्सयौं	u n̪ ä n̪ s j ʌ̃ ũ̯
भण्डारी	bʱ ʌ n̪ d̪ ä r i
गन्धर्व	ɡ ʌ n̪ d̪ʱ ʌ r ʋ
फट्कार्	pʰ ʌ t̪ k ä r
रेग्मी	r e ɡ m i
अर्थात्	ʌ r t̪ʰ ä t̪
जय	d͡z j ä
घत्रक्क	ɡʱ ʌ t̪ r ʌ k k
ऐहिक	ʌ i ɦ i k
कर्‌याम्म	k ʌ r j ä m m
दगुराइ	d̪ ʌ ɡ u r ä i
त्रिवेणी	t̪ r i ʋ e n̪ i
देवीप्रसाद	d̪ e ʋ i p r ʌ s ä d̪
दँतुली	d̪ ʌ̃ t̪ u l i
रुढी	r u ɖ i
गाला	ɡ ä l ä
आकाङ्क्षी	ä k ä ŋ kʰ ʃ i
आहृत	ä ɦ r i t̪
चास्स	t͡ʃ ä s s
सतराज	s ʌ t̪ ʌ r ä d͡z
एकानी	e k ä n̪ i
स्वज्ञान	s ʋ ʌ d͡z j ä n̪
चोब्	t͡ʃ o b
मिट्टी	m i ʈ ʈ i
अकबरि	ʌ k ʌ b ʌ r i
खटिरा	kʰ ʌ ʈ i r ä
सावा	s ä ʋ ä
अकथित	ʌ k ʌ t̪ʰ i t̪
उपरि	u p ʌ r i
झुत्रेझाम्रे	d͡zʱ u t̪ r e d͡zʱ ä m r e
छाउरो	t͡sʰ ä u r o
खाग्सी	kʰ ä ɡ s i
भरभित्तो	bʱ ʌ r bʱ i t̪ t̪ o
धीर	dʱ i r
कुञ्जी	k u ɲ d͡z i
डिनर	ɖ i n ʌ r
कल्पक	k ʌ l p ʌ k
बेसारे	b e s ä r e
दम्क	d ʌ m k
कटहर	k ʌ t̪ ʌ h ʌ r
अष्टमान	ʌ s̠ t̪ m ä n
कर्कट	k ʌ r k ʌ t̪
ठमेल	t̪ʰ ʌ m e l
डच	ɖ ʌ t͡sʰ
कुचेष्टा	k u t͡sʰ e s̠ t̪ ä
गोरु	ɡ o r u
रल्लि	r ʌ l l i
गढी	ɡ ʌ ɖ i
विजयोत्सव	b i d͡z ʌ j o t̪ s ʌ b
पदस्थापन	p ʌ d ʌ s t̪ʰ ä p ʌ n
चण्ड	t͡s ʌ n̪ ɖ
लक्ष	l ʌ k̚ t̪ʃ
भूईँचालो	bʱ u ĩ t͡s ä l o
तीव्रता	t̪ i b r ʌ t̪ ä
च्याँसे	t͡sʰ j ä̃ s e
फापर	pʰ ä p ʌ r
रुढी	r u ɖ i
जग्गाजमिन	d͡z ʌ ɡ ɡ ä d͡z ʌ m i n
मुड्की	m u ɖ k i
भँगालि	bʱ ã ɡ ä l i
आलस्य	ä l ʌ s j ʌ
छेका	t͡sʰ e k ä
प्रहास	p r ʌ h ä s
अबाध्य	ʌ b ä dʱ j ʌ
इन्क्लाब	i n k l ä b
काठ	k ä t̪ʰ
कोटिनाम	k o t̪ i n ä m
जर्मनी	d͡z ʌ r m ʌ n i
अनुन्मुक्त	ʌ n u n m u k t̪
टुलुक्क	t̪ u l u k k
पत्रिका	p ʌ t̪ r i k ä
कस्तो	k ʌ s t̪ o
ठूलाबडा	t̪ʰ u l ä b ʌ d̪ ä
ग्रामीण	ɡ r ä m i n
भित्र	bʱ i t̪ r
कङ्गाल	k ʌ ŋ ɡ ä l
शान्तिवार्ता	s̠ ä n t̪ i b ä r t̪ ä
गडगड	ɡ ʌ ɖ ɡ ʌ ɖ
ठमेल	ʈʰəmeːl
तत्त्व	tət̪t̪ʋə
सदासर्वदा	səd̪aːsərʋəd̪aː
सेड	seːɖ
अन्तर्विरोध	ənt̪ərʋiroːd̪ʱ
मिसोट	misoːʈ
साँच्चै	sãːt͡ʃt͡ʃəi
काव्यशैली	kaːʋjəʃəiliː
कम्ती	kəmt̪iː
कन्पारो	kənpaːro
चोक	t͡ʃoːk
एत्तेरी	eːt̪t̪eːriː
झाँगकझुँगल	d͡ʒʱãːɡəkd͡ʒʱũːɡəl
मस्यौदा	məsjəudaː
अस्तित्व	əst̪it̪ʋə
चिरचिरे	t͡ʃirət͡ʃireː
ऊर्ध्वगामी	uːrd̪ʱʋəɡaːmiː
औलो	auloː
अद्यपि	əd̪jəpi
अब्राहम	əbraːɦəm
चुबुरचुबुर	t͡ʃuburət͡ʃubur
रात्रि	raːt̪ri
अगणनीय	əɡəɳəniːjə
वीरगति	ʋiːrəɡət̪i
भद्राक्ष	bʱəd̪raːkʃ
चपेटा	t͡ʃəpeːʈaː
सेलफोन	seːləfon
छकाउ	t͡ʃʰəkaːu
छन्	t͡ʃʰən
उहिले	uhilə
बोटे	boːʈeː
कचिल्लो	kət͡ʃilːo
ख्याति	kʰjaːt̪i
समेना	səmeːnaː
परापूर्व	pəraːpuːrʋə
त्रिगिरी	t̪riɡiriː
बाईस	baːis
रेडक्रस	reːɖəkrəs
आह्‍लाद	aːɦlaːd̪
गज्क	ɡəd͡ʒək
घरधुरी	ɡʱərəd̪ʱuriː
इकोसिस्टम	ikosisʈəm
सञ्चालिका	səɲt͡ʃaːlikaː
पराल	pəraːl
छ्याप	t͡ʃʰjaːp
अनुत्पादक	ənut̪paːd̪ək
मार्कअप	maːrkəp
उपवक्ता	upəʋəkt̪aː
खुड्किलो	kʰuɖkilo
धाई	d̪ʱaːi

    राष्ट्रबैँक	r ä ʂʈ r ʌ b ä̃ ŋ k
गुठी	ɡ u ʈʰ i
टनकपुर	ʈ n ʌ k ʌ p u r
पग्लि	p ʌ ɡ l i
धनुर्धर	d̪ʱ ʌ n u r d̪ʱ ʌ r
बाउसे	b ä u s e
तेक्वान्दो	t̪ e k w ä n d̪ o
खिच्चड	kʰ i t͡ʃ t͡ʃ ʌ ɖ
अन्यथा	ʌ n j ʌ t̪ʰ ä
तिखार्	t̪ i kʰ ä r
अकलगुम	ʌ k ʌ l ʌ ɡ u m
गणना	ɡ ʌ ɳ ʌ n ä
सुमित्रा	s u m i t̪ r ä
घडघडे	ɡʱ ʌ ɖ ɡʱ ʌ ɖ e
बत्ताउ	b ʌ t̪ t̪ ä u
रेलिङ	r e l i ŋ
समाचारदाता	s ʌ m ä t͡ʃ ä r d̪ ä t̪ ä
उपलब्धता	u p ʌ l ʌ bʱ d̪ʱ t̪ ä
अन्तर्त्वचा	ʌ n t̪ ʌ r t̪ w ʌ t͡ʃ ä
छ्‌वाँके	t͡ʃʰ w ä̃ k e
भरभित्तो	bʱ ʌ r bʱ i t̪ t̪ o
मुस्लिम	m u s l i m
मसौदा	m ʌ s ʌ u d̪ ä
सम्भ्रम	s ʌ m bʱ r ʌ m
ख्याक	kʰ j ä k
भुक्लुक्क	bʱ u k l u k k
आत्था	ä t̪ʰ ä
खबटे	kʰ ʌ b ʌ ʈ e
खाइखुई	kʰ ä i kʰ u i
एकसट्ठीऔं	e k ʌ s ʌ ʈʰ i ʌ̃
अभिमत	ʌ bʱ i m ʌ t̪
औलो	ʌ u l o
गन्धर्व	ɡ ʌ n d̪ʱ ʌ r w
त्रिगिरी	t̪ r i ɡ i r i
वारुणयन्त्र	w ä r u ɳ j ʌ n t̪ r
सावा	s ä w ä
अपुत	ʌ p u t̪
एक्काईस	e k k ä i s
पिरपिर	p i r p i r
अनुगृहीत	ʌ n u ɡ r ʱ i t̪
विवश	w i w ʌ ʂ
बङ्गला	b ʌ ŋ ɡ l ä
वैल	w ä i l
खन	kʰ ʌ n
किस्मती	k i s m ʌ t̪ i
अधबैँसे	ʌ d̪ʱ ʌ b ä̃ s e
शासनपतन्त्र	ʂ ä s ʌ n p ʌ t̪ ʌ n t̪ r
शारदा	ʂ ä r ʌ d̪ ä
दनदन	d̪ ʌ n ʌ d̪ ʌ n
बड्‍कौँलो	b ʌ ɖ k ʌ̃ l o

    पाउँ	pā̤ũ
निश्‍वास	niʃ‍vā̤s
राधेश्याम	rā̤d̪ʱeʃjā̤m
चक्राङ्कित	t͡ʃʌkrā̤ŋkit
उहिले	uʱile
ढुकढुकी	ɖʱʊkɖʱʊki
बिख	bikʰ
प्रहास	prā̤ʱā̤s
सिकुटी	sikʊʈi
जगण	d͡ʒʌɡʌɳ
क्षति	kʂʌt̪i
भद्राक्ष	bʱʌdrā̤kʂ
झ्याप्लो	d͡ʒʱjā̤plo
दुलही	dʊlā̤ʱi
दम्क	dʌmk
बदाम	bʌdā̤m
निम्की	nimki
पट्टी	pʌʈʈi
फट्ट	pʰʌʈʈ
परापूर्व	parā̤pūrv
बान्की	bā̤nki
कहीं	kʌhĩ
फापर	pʰā̤pʌr
सुनार	sunā̤r
घर्ती	ɡʱʌrti
पैले	paile
वायुमण्डल	vā̤jūmʌɳɖʌl
झन्क	d͡ʒʱʌnk
आभ्यन्तरिक	ā̤bʱjʌnt̪ʌrik
गदरी	ɡʌdʌri
गलकट्टा	ɡʌlʌkʈʈā̤
असांसद	ʌsā̤̃sʌd
दिलमाया	dilmā̤jā̤
किंवदन्ती	kĩvʌdʌnti
माफ	mā̤pʰ
मर्चेन्ट	mʌrt͡ʃent̪
खुकुलो	kʰʊkʊlo
स्याल्ल	sjā̤l
उपनिवेशवाद	upʌniveʃvā̤d
भ्वाँक	bʱvā̤̃k
हल्ट	ʱʌlʈ
आख्यायक	ā̤kʱjā̤jak
सरणि	sʌrʌɳi
चेहरा	t͡ʃeʱʌrā̤
ल्यापल्यापती	ljā̤pljā̤pti
फुस्रो	pʰʊsro
लचकता	lʌt͡ʃʌkʌt̪ā̤
सनातन	sʌnā̤t̪ʌn
घ्न	ɡʱn
वाक्यविश्लेषण	vā̤kjʌviʃleʂʌɳ
धर्सो	dʱ ʌ r s o
मच्च	m ʌ t͡ʃ t͡ʃ
रौँ	r aʊ̯̃
अमानवी	ʌ m ɑː n ʌ ʋ iː
लुटपुट	l ʊ ʈ p ʊ ʈ
पुलुपुलु	p ʊ l ʊ p ʊ l ʊ
ह्नेदिक	ɦ n eː d i k
पुडिया	p ʊ ɖ iː j ɑː
साँगु	s ɑ̃ː ɡ u
आपत्ति	ɑː p ʌ t̪ t̪ i
तानाशाह	t ɑː n ɑː ʃ ɑː ɦ
स्तरीयता	s t̪ ʌ r iː j ʌ t̪ ɑː
बिङ्गो	b i ŋ ɡ o
छटपटी	t͡ʃʰ ʌ ʈ p ʌ ʈ iː
झुरुमुरु	d͡ʒʱ ʊ r ʊ m ʊ r ʊ
बदाम	b ʌ d ɑː m
रेखाचित्र	r eː kʰ ɑː t͡ʃ i t̪ r
हर्न	ɦ ʌ r n
सृजनशीलता	s r̩ d͡ʒ n ʌ ʃ iː l ʌ t̪ ɑː
धोका	dʱ oː k ʌ
पुरस्कार	p ʊ r ʌ s k ɑː r
उल्टाइ	u l ʈ ɑː i
सावा	s ɑː ʋ ɑː
असन्तोकी	ʌ s ʌ n t̪ oː k iː
बिछ्यौना	b i t͡ʃʰ j aʊ̯ n ɑː
आदिवासी	ɑː d i ʋ ɑː s iː
काटमार	k ɑː ʈ m ɑː r
उच्छन्न	u t͡ʃʰ ʌ n n
दिउँसो	d iː ʊ̃ s o
अभ्यर्थना	ʌ bʱ j ʌ r t̪ʰ n ɑː
आजानुबाहु	ɑː d͡ʒ ɑː n ʊ b ɑː ɦ ʊ
फ्वाँक्क	pʰ ʋ ɑ̃ː k k
किस्मती	k i s m ʌ t̪ iː
प्राचीन	p r ɑː t͡ʃ iː n
पोर्ट	p oː r ʈ
पस्मिना	p ʌ s m iː n ɑː
रुक्मिणी	r ʊ k m iː n iː
सिनेमा	s i n eː m ɑː
बाउँडि	b ɑː ʊ̃ ɖ i
ख्यातनामा	kʰ j ɑː t̪ ʌ n ɑː m ɑː
अडभङ्ग्याहा	ʌ ɖ bʱ ʌ ŋ j ɑː ɦ ɑː
मामा	m ɑː m ɑː
कच्चो	k ʌ t͡ʃ t͡ʃ o
डँड्याउ	ɖ ʌ̃ ɖ j aʊ̯
रक्तचाप	r ʌ k t̪ t͡ʃ ɑː p
हाडछाला	ɦ ɑː ɖ t͡ʃʰ ɑː l ɑː
भरथरी	bʱ ʌ r ʌ t̪ʰ r iː
ठेट्ना	ʈʰ eː t̪ n ɑː
जितुवा	d͡ʒ i t̪ u ʋ ɑː
खकार्	kʰ ʌ k ɑː r
निथ्रुक्क	n i tʰ r u k k
कार्बनडाइअक्साइड	k ɑː r b ʌ n d ɑː i ʌ k s ɑː i d
कार्यशैली	k ɑː r j ʌ ʃ ɑː i l iː
गँजडी	g æ̃ ʤ ʌ d iː
उफ्रौला	u pʰ r ɔː l ɑː
जलजलाउँदो	ʤ ʌ l ʤ ʌ l ɑː ũ d o
अन्दोलन	ʌ n d o l ʌ n
दापा	d ɑː p ɑː
रक्सौल	r ʌ k s ɔː l
खुरुङ्गो	kʰ u r u ŋ g o
ख्याक्क	kʰ j ɑː k k
जम्बु	ʤ ʌ m b u
बत्ती	b ʌ t t iː
कल्पक	k ʌ l p ʌ k
अर्घौतो	ʌ r gʰ ɔː t o
सराप्	s ʌ r ɑː p
गणतन्त्री	g ʌ n ʌ t ʌ n t r iː
सुकसुक	s u k ʌ s u k
केशव	k eː ʃ ʌ v
उग्रवाद	u g r ʌ v ɑː d
आँखीभुईँ	ɑː ŋ kʰ iː bʰ u ĩ
झिँजोल्	ʤʰ ĩ ʤ o l
बिङ्गो	b i ŋ g o
अभिबृद्धि	ʌ bʰ i b r ʌ dʰ i
फुत्रुक्क	pʰ u t r u k k
झोक्का	ʤʰ o k k ɑː
खाल	kʰ ɑː l
औस्या	ɔː s j ɑː
फ्याक्स	pʰ j ɑː k s
विकास	v i k ɑː s
बान्की	b ɑː n k iː
बेल्ट	b eː l ʈ
स्वालस्वाल	s w ɑː l s w ɑː l
अभिशाप	ʌ bʰ i ʃ ɑː p
अभुक्त	ʌ bʰ u k t
आचमन	ɑː tʃ ʌ m ʌ n
हप्कीदप्की	ɦ ʌ p k iː d ʌ p k iː
कोफी	k o pʰ iː
चर्	tʃ ʌ r
हिमचुली	ɦ i m ʌ tʃ u l iː
प्वाँख	p w ɑː ŋ kʰ
पट्याउ	p ʌ ʈ j ɑː u
हाइसुक्ख	ɦ ɑː i s u kʰ
पक्राउ	p ʌ k r ɑː u
डफ्फा	ɖ ʌ pʰ ʌ
अदालत	ʌ d ɑː l ʌ t
जत्ति	ʤ ʌ t t iː
ओइरि	o i r i
बहुलाउ	b ʌ ɦ u l ɑː u
माल्टा	m ɑː l ʈ ɑː
होचि	ɦo.t͡ʃi
एक्सप्रेशन	ek.spre.ʃən
फुत्रुक्क	pʰu.tru.kkə
मिजासी	mi.d͡ʒa.si
भ्वाँक	bʱʋãːk
थासो	tʰaː.so
हपाहप	ɦə.paː.ɦəp
अध:पतन	ədʱə.pə.tən
छ्याकन	t͡ʃʰjaː.kən
चेप्रो	t͡ʃe.pro
रेलिङ	re.liŋ
समाजशास्त्र	sə.maːd͡ʒ.ʃaːs.trə
आत्मपरक	aːt.mə.pərək
लिपपोत	li.pə.poʈ
लौका	lau.kaː
छ्याट्ट	t͡ʃʰjaːʈʈ
विष्फोट	ʋiʂ.pʰoʈ
प्राचीनता	praː.t͡ʃiː.nə.taː
ठेट्ना	ʈʰeʈ.naː
अरिनी	ə.ri.niː
कोल्टे	ko.lʈe
कुव्यवहार	ku.ʋjə.ʋə.ɦaːr
मरमरम्मत	mər.mər.mət
प्यारा	pjaː.raː
कसजू	kəs.ə.d͡ʒuː
कार्चोपी	kaːr.t͡ʃo.piː
रामनारायण	raːm.naː.raː.jən
सहृयार्	sə.ɦr.jaːr
प्राची	praː.t͡ʃiː
टुङ्‍ना	ʈuŋ.naː
असहन	ə.sə.ɦən
क्यास्ट्रो	kjaːs.ʈro
उछिनपाछिन	u.t͡ʃi.nə.paː.t͡ʃi.nə
विम्बविधान	ʋim.bə.ʋi.dʱaːn
खोसेल्	kʰo.se.l
प्रवर्तन	prə.ʋər.tən
रुपा	ru.paː
कर्णफूल	kər.nə.pʰuːl
तमोर	tə.mor
गर्माउ	ɡər.maː.u
जर्कट	d͡ʒər.kəʈ
गहते	ɡə.ɦə.te
क्यापिटल	kjaː.pi.ʈəl
जैरे	d͡ʒai.re
एकाउन्ट	e.kaː.unʈ
इच्छुक	i.t͡ʃʰu.kə
रचनाकार	rə.t͡ʃə.naː.kaːr
अनिल	ə.nil
मम	məm
मालश्री	maːl.ʃriː
एकेक	ɛkɛk
हुर्रि	hʊrri
रेडियम	rɛɖijʌm
वर्काइफर्काइ	vʌrkɑːifʌrkɑːi
गिरावट	girɑːvʌʈ
आर्जे	ɑːrjɛ
काटमार	kɑːʈmɑːr
लिपित्त	lipitʈ
उनन्‍तीस	unʌntiːs
कट्टु	kʌʈʈu
भेडो	bʰɛɖo
धानबाली	ɖʰɑːnʌbɑːliː
मन्स	mʌns
बेकाम	bɛkɑːm
चुभुर्कि	t͡ʃʊbʰʊrki
गुलाब	gulɑːb
मापन	mɑːpʌn
आधार	ɑːɖʰɑːr
नैवेद	nɑːivɛd
पहल	pʌhʌl
गोठालो	goʈʰɑːlo
टकराउ	ʈʌkrɑːu
टिलटिलती	ʈilʈilʌtiː
डँड्याउ	ɖʌɳɖjɑːu
सिधेनुन	siɖʰɛnʊn
झुप्पि	ʤʰʊppi
ठूलाबडा	ʈʰuːlɑːbʌɖʌ
नक्साल	nʌksɑːl
कैलाश	kɑːilɑːʃ
डबल	ɖʌbʌl
तड्कारै	tʌɖkɑːrɑːi
लोति	loʈi
रतन	rʌtʌn
चाख	t͡ʃɑːkʰ
भ्यालेन्टाइन	bʰjɑːlɛnʈɑːin
गर्	gʌr
लडे	lʌɖɛ
आहृत	ɑːhʌrt
लाउ	lɑːu
एम्बुलेन्स	ɛmbulɛns
मस्यौदा	mʌsjɑːudʌ
अपसारी	ʌpsɑːriː
उम्त्याहा	ʊmtjɑːhɑː
लोग्नेमानिस	lognɛmɑːnis
झुरो	ʤʰʊro
खलनायक	kʰʌlnɑːjʌk
मेधा	mɛɖʰɑː
आविष्ट	ɑːviʃʈ
उत्तान	ʊttɑːn
छूती	t͡ʃʰuːtiː

    ला	l ä
गृष्म	ɡ r ɪ ʂ m
ऋणदाता	r ɪ ɳ d ɑː t ɑː
बुर्की	b ʊ r k iː
उत्क्रमण	ʊ t k r ʌ m ɳ
अछापे	ʌ t͡ʃʰ ɑː p e
अल्पमत	ʌ l p m ʌ t
खस	kʰ ʌ s
एकराते	e k ʌ r ɑː t e
पटरी	p ʌ ʈ r iː
रसायन	r ʌ s ɑː j ʌ n
दासत्व	d ɑː s ʌ t w
मजनु	m ʌ d͡ʒ n ʊ
बन्जारो	b ʌ n d͡ʒ ɑː r oː
गोठपाला	ɡ oː ʈʰ p ɑː l ɑː
लालसा	l ɑː l s ɑː
जीर्णोद्धार	d͡ʒ iː r ɳ oː dʱ ɑː r
झुरुमुरु	d͡ʒʱ ʊ r ʊ m ʊ r ʊ
ग्वाँचे	ɡ w ɑ̃ː t͡ʃ e
आँच	ɑ̃ː t͡ʃ
गणतन्त्री	ɡ ʌ ɳ ʌ t ʌ n t r iː
भत्कोस	bʱ ʌ t k oː s
चुन्	t͡ʃ ʊ n
झाँगकझुँगल	d͡ʒʱ ɑ̃ː ɡ ʌ k d͡ʒʱ ʊ̃ː ɡ ʌ l
कछार	k ʌ t͡ʃʰ ɑː r
पघार्	p ʌ ɡʱ ɑː r
बिन्ती	b iː n t iː
भुटान	bʱ ʊ ʈ ɑː n
भाम्लो	bʱ ɑː m l oː
सिट्	s iː ʈ
चौतीसौं	t͡ʃ ɔː t iː s ɔ̃ː
ब्रस	b r ʌ s
सन्तति	s ʌ n t ʌ t iː
सेड	s eː ɖ
चिन्ता	t͡ʃ iː n t ɑː
झञ्झावर्णन	d͡ʒʱ ʌ ɲ d͡ʒʱ ɑː w ʌ r ɳ ʌ n
ढैंचा	ɖʱ ɛ̃ː t͡ʃ ɑː
अव्यवस्था	ʌ w j ʌ w ʌ s ʈʰ ɑː
रूहु	r uː h ʊ
ठक्रक्क	ʈʰ ʌ k r ʌ k k
एकेक	eː k eː k
धुनी	dʱ ʊ n iː
पहल	p ʌ ɦ ʌ l
उत्तरदाता	ʊ t t ʌ r d ɑː t ɑː
लोक	l oː k
तपाईँ	t ʌ p ɑː ĩː
द्विज	d w iː d͡ʒ
बढीमालिका	b ʌ ɖʱ iː m ɑː l iː k ɑː
फैसला	pʰ ɛː s ʌ l ɑː
ह्रास	ɦ r ɑː s
जनस्तर	ʤ ʌ n ʌ s t̪ ʌ r
अन्सारी	ʌ n s ä r i
कुण्ठा	k u ɳ ʈʰ ä
धड्	d̪ʱ ʌ ɖ
जर्याक्क	ʤ ʌ r j ä k k
टमटम	ʈ ʌ m ʈ ʌ m
रघुवीर	r ʌ ɡʱ u w i r
तिब्बत	t̪ i b b ʌ t̪
जारीपत्र	ʤ ä r i p ʌ t̪ r
भावक	bʱ ä w ʌ k
बछेडा-बछेडी	b ʌ t͡ʃʰ e ɖ ä - b ʌ t͡ʃʰ e ɖ i
पक्कै	p ʌ k k ä i
महानिर्वाचन	m ʌ ɦ ä n i r w ä t͡ʃʰ ʌ n
आन्दोलन	ä n d̪ o l ʌ n
बस्ताकोटी	b ʌ s t̪ ä k o ʈ i
इञ्जिनियर	i ɲ ʤ i n i j ʌ r
कठ्याङ्ग्रि	k ʌ ʈʰ j ä ŋ ɡ r i
थुर्	ʈʰ u r
हिक्मत	ɦ i k m ʌ t̪
साइनो	s ä i n o
ह्रास	ɦ r ä s
तपेस	t̪ ʌ p e s
छ्याप	t͡ʃʰ j ä p
च्याँसे	t͡ʃ j ä̃ s e
आती	ä t̪ i
सङ्ल	s ʌ ŋ l
आज्ञा	ä ʤ ɲ ä
कन्पारो	k ʌ n p ä r o
माफ	m ä pʰ
सुरेन्द्र	s u r e n d̪ r
कुँडुली	k ũ ɖ u l i
प्रिन्ट	p r i n ʈ
विवश	w i w ʌ s
ट्याङट्याङ	ʈ j ä ŋ ʈ j ä ŋ
अंशुवर्मा	ʌ̃ s u w ʌ r m ä
विष्फोट	w i s pʰ o ʈ
वायुमण्डल	w ä j u m ʌ ɳ ɖ ʌ l
ऋकार	r i k ä r
आराम	ä r ä m
सिधेनुन	s i d̪ʱ e n u n
अविकल	ʌ w i k ʌ l
रोध	r o d̪ʱ
याँ	j ä̃
जन्मदिन	ʤ ʌ n m ʌ d̪ i n
दर्पण	d̪ ʌ r p ʌ ɳ
जप्	ʤ ʌ p
ट्रयाकबल	ʈ r j ä k ʌ b ʌ l
अमलची	ʌ m ʌ l t͡ʃʰ i
तरखर	t̪ ʌ r kʰ ʌ r
आभारी	ä bʱ ä r i

    कन्पारो	k ʌ n p ɑː r o
झडप	d͡zʱ ʌ d̪ p
बुढिया	b u ɖ i j ɑː
र्‌याखर्‌याख	r j ɑː kʰ r j ɑː kʰ
शय्या	ʃ ʌ j j ɑː
बरन्डा	b ʌ r ʌ n ɖ ɑː
सम्मेलन	s ʌ m m e l ʌ n
एन	e n
छठ	t͡sʰ ʌ t̪ʰ
पुकपाक	p u k ʌ p ɑː k
अरुचिकर	ʌ r u t͡ʃ i k ʌ r
टाल	t̪ ɑː l
वीरगति	v iː r ʌ ɡ ʌ t̪ i
यथेच्छ	j ʌ t̪ʰ e t͡ʃʰ
विशालबजार	v i ʃ ɑː l b ʌ d͡z ɑː r
उत्प्लावन	u t̪ p l ɑː v ʌ n
अलेख	ʌ l e kʰ
ल्याफल्याफती	l j ɑː f l j ɑː f t̪ iː
गलसेरा	ɡ ʌ l s e r ɑː
कन्दनी	k ʌ n d ʌ n iː
डोरि	ɖ o r i
अकर्मण्यता	ʌ k ʌ r m ʌ ɳ j ʌ t̪ ɑː
सराप्	s ʌ r ɑː p
आक्रामक	ɑː k r ɑː m ʌ k
उत्तप्त	u t̪ t̪ ʌ p t̪
लोग्नेमानिस	l o ɡ n e m ɑː n i s
आर्ज	ɑː r d͡z
अभिवन्दनीय	ʌ bʱ i v ʌ n d ʌ n iː j ʌ
मात्ति	m ɑː t̪ t̪ i
हल	ɦ ʌ l
ऐन	ɑː i n
अठार	ʌ t̪ʰ ɑː r
मन्दी	m ʌ n d iː
अल्पस्मृति	ʌ l p s m ʌ r t̪ i
तनखा	t̪ ʌ n kʰ ɑː
ज्यामी	d͡z j ɑː m iː
छ्या	t͡sʰ j ɑː
जनतन्त्र	d͡z ʌ n ʌ t̪ ʌ n t̪ r
जुस	d͡z u s
अधिवक्ता	ʌ dʱ i v ʌ k t̪ ɑː
आर्यसमाजी	ɑː r j ʌ s ʌ m ɑː d͡z iː
मुसुक्क	m u s u k k
आङ्ग्ल	ɑː ŋ ɡ l
उघाउ	u ɡʱ ɑː u
भावक	bʱ ɑː v ʌ k
उपचारी	u p ʌ t͡ʃ ɑː r iː
जिबुल्लि	d͡z i b u l l i
श्रेणी	ʃ r e n iː
क्यापिटल	k j ɑː p i t̪ ʌ l
फाराम	f ɑː r ɑː m

    सम्पूर्णता	s ʌ m p u r n t a
टुकटुकती	ʈ u k ʈ u k ʈ i
सहृयार्	s ʌ ɦ r j a r
सुनुवार	s u n u b a r
कर्णफूल	k ʌ r n ʌ f u l
चमचम	t͡ʃ ʌ m t͡ʃ ʌ m
थाल्नी	ʈʰ a l n i
झट्कार्	d͡zʱ ʌ ʈ k a r
खुच्चिङ	kʰ u t͡ʃ t͡ʃ i ŋ
#टकटक्याहा	ʈ ʌ k ʈ ʌ k j a ɦ a
सेप	s e p
चन्दने	t͡ʃ ʌ n d ʌ n e
लटपट	l ʌ ʈ p ʌ ʈ
गिर्खा	ɡ i r kʰ a
अनार्य	ʌ n a r j
विदुर	b i d u r
कागत	k a ɡ ʌ t
वहि:	b ʌ ɦ i
साँढी	s a ɳ ʈʰ i
पुस्टाउ	p u s ʈ a u
भाक्	bʱ a k
गर्माउ	ɡ ʌ r m a u
घनश्याम	ɡʱ ʌ n ʃ j a m
पावरनाथ	p a b ʌ r n a ʈʰ
कम्बल	k ʌ m b ʌ l
होचि	ɦ o t͡ʃ i
संपादन	s ʌ m p a d ʌ n
माफ	m a f
प्रेमकथा	p r e m k ʌ ʈʰ a
चक्क	t͡ʃ ʌ k k
जहडी	d͡z ʌ ɦ ʌ d i
उत्पीडन	u t p i ʈ ʌ n
अनुसूचक	ʌ n u s u t͡ʃ ʌ k
भरभित्तो	bʱ ʌ r bʱ i t ʈ o
निजगढ	n i d͡z ʌ ɡ ʌ ʈʰ
लिखु	l i kʰ u
रुझ्	r u d͡zʱ
पूर्णिमा	p u r n i m a
चिरबिरे	t͡ʃ i r b i r e
पछ्यौरा	p ʌ t͡ʃ j a u r a
समागम	s ʌ m a ɡ ʌ m
मुरि	m u r i
मुख्तियार	m u kʰ t i j a r
उपप्रमुख	u p ʌ p r ʌ m u kʰ
लिसीपिसी	l i s i p i s i
लगार्	l ʌ ɡ a r
निराश	n i r a ʃ
क्रमाङ्कन	k r ʌ m a ŋ k ʌ n
घुन्न	ɡʱ u n n
छुमछुम	t͡ʃʰ u m t͡ʃʰ u m

    प्याकुरेल	pjɑːkurel
मनोभावना	mɐnobʱɑːʋɐnɑː
वीर	ʋiːr
एकरस	ekɐrɐs
मूल	muːl
थाली	tʰɑːliː
विकार	ʋikɑːr
लोचन	locʰɐn
दाजुभाइ	dɑːd͡ʒubʱɑːi
निःस्वार्थ	nisʋɑːrtʰ
मङ्गलाचरण	mʌŋɡɑːlɑːt͡ʃɐrɐn
दुर्दशा	durdɐʃɑː
छकि	t͡ʃʰɐki
उत्तेजन	utːeːd͡ʒɐn
पृष्ठसाइज	prʊʂʈʰsɑːid͡ʒ
गुँडुल्कि	gʊɳɖulkɪ
चुबुरचुबुर	t͡ʃuburɐt͡ʃubur
ग्लानि	glɑːni
भित्तेलेखन	bʱitt̪elekʰɐn
घोचुवा	ɡʱocʰuwɑː
झुस्याहा	d͡ʒʰusjɑːhɑː
त्रिपासा	tripɑːsɑː
किड्नी	kɪɖniː
रैकर	raikɐr
वेदान्त	ʋedɑːnt̪
खोतल्	kʰot̪ɐl
धान्	dʱɑːn
कठोरपन	kʌʈʰorɐpɐn
खतरा	kʰɐt̪ɐrɑː
चट्याङ्ग	t͡ʃʌʈjɑːŋɡ
अनुत्पादित	ɐnut̪pɑːdɪt̪
कलकल	kɐlkɐl
सह्यार्	sɐhjɑːr
अकथनिय	ɐkʌt̪ʰɐniː
आङ्गारिक	ɑːŋɡɑːrik
लत्र्याङ्ङ	lɐtrjɑːŋɡ
शुभ	ʃubʱ
टाउको	ʈɑːuko
ओछो	oːt͡ʃʰo
आल्मारी	ɑːlmɑːriː
उप-मार्ग	up-mɑːrɡ
गजुरी	ɡɐd͡ʒuriː
कुहिरे	kʊhire
प्रसन्न	prɐsɐnn
सप्र्याक	sɐprjɑːk
तत्त्व	t̪ɐt̪t̪ʋ
माधव	mɑːdʱʋ
उल्था	ulʈʰɑː
संवास	sʌ̃ʋɑːs
सतबिउ	sɐt̪ɐbiu
खोत्ति	kʰ o t̪ː i
लक्षण	l ʌ kʰ ʃ ʌ n
सिसार	s i s ɑː r
विलक्षण	ʋ i l ʌ kʃ ʌ n
पुकपाक	p u k ʌ p ɑː k
आयुष्मान	ɑː j u ʃ m ɑː n
जातपतित	j ɑː t̪ ʌ p ʌ t̪ i t̪
ख्याल	kʰ j ɑː l
गोङ्गबु	ɡ o ŋ ɡ ʌ b u
हरहर	ɦ ʌ r ʌ ɦ ʌ r
उपवक्ता	u p ʌ ʋ ʌ k t̪ ɑː
बिक्	b i k
कट्टू	k ʌ t̪ː uː
आक्षेपक	ɑː kʃ e p ʌ k
सुकुटे	s u k u t̪ e
महानिर्वाचन	m ʌ ɦ ɑː n i r ʋ ɑː t͡ʃ ʌ n
उन्नायक	u nː ɑː j ʌ k
आविष्ट	ɑː ʋ i ʃ t̪
छुद्र	t͡ʃʰ u d̪ r
कसजू	k ʌ s ʌ d͡ʒ uː
ढिलो	ɖʱ i l o
जुस	d͡ʒ u s
फलैँचा	pʰ ʌ l ɛ̃ t͡ʃ ɑː
जङ्गि	d͡ʒ ʌ ŋ ɡ i
दपेटाइ	d ʌ p e t̪ ɑː i
बाध्य	b ɑː dʱ j ʌ
दैनिकी	d̪ ɑː i n i k iː
पुतौरो	p u t̪ ɔː r o
परीक्षण	p ʌ r iː kʃ ʌ n
कामधेनु	k ɑː m ʌ d̪ʱ e n u
टाउको	t̪ ɑː u k o
वेबफोल्डर	ʋ e b pʰ o l d̪ ʌ r
हिनामिना	ɦ i n ɑː m i n ɑː
अश्रुत	ʌ ʃ r u t̪
भुट्को	bʱ u t̪ k o
एकस्व	e k ʌ s ʋ
टुक्रि	t̪ u k r i
आती	ɑː t̪ i
भुटान	bʱ u t̪ ɑː n
उछिनपाछिन	u t͡ʃʰ i n ʌ p ɑː t͡ʃʰ i n
अस्पष्टता	ʌ s p ʌ ʃ t̪ ʌ t̪ ɑː
आभासित	ɑː bʱ ɑː s i t̪
भँगडी	bʱ ə ŋ ɡ ʌ d̪ i
व्यङ्ग्य	ʋ j ʌ ŋ ɡ j ʌ
आशामुखी	ɑː ʃ ɑː m u kʰ iː
कलैया	k ʌ l ɛː j ɑː
फट्कार्	pʰ ʌ t̪ k ɑː r
चौतीसौं	t͡ʃ ɔː t̪ iː s ɔ̃
उपविष्ट	u p ʌ ʋ i ʃ t̪
बाउसे	b ɑː u s e
फुल्चोकी	phulʧoki
प्यास	pjɑːs
धान्	dʱɑːn
धर्सो	dʱərso
मसौदा	məsɔdɑː
खेदुवा	kʰeduvɑː
भगाङ्कुर	bʱəgɑːŋkur
अनाडी	ənɑːdiː
हारगुहार	hɑːrguhɑːr
शिल्प	ʃilp
झ्यालखाना	d͡ʒʱjɑːlkʰɑːnɑː
पेन्टिङ	pentɪŋ
वनसाङ्लो	vənɑːŋlo
चवालीसौं	t͡ʃəvɑːlisɔ̃
आत्था	ɑːtʰʰɑː
ससीम	səsim
विद्यार्जन	vidjɑːrd͡ʒən
पुच्छर	pʊt͡ʃʰər
माधव	mɑːdʱəv
ख्यात	kʰjɑːt
आशामुखी	ɑːʃɑːmukʰiː
जर्याक्क	d͡ʒərjɑːkʰkʰ
निवृत्त	nivɹ̩t
घेराबन्दी	ɡʱerɑːbəndiː
चेकपोस्ट	t͡ʃekpɔst
अवधि	əvədʱi
तन्दा	təndɑː
आविष्ट	ɑːviʃʈ
भरपाई	bʱərpɑːi
चञ्चले	t͡ʃənt͡ʃəle
कठोरपन	kəʈʰɔrəpən
सइस	səis
गोदावरी	godɑːvəri
चुइँकने	t͡ʃuinkəne
कोल्टे	kolʈe
राजश्व	rɑːd͡ʒʃvə
अब्राहम	əbrɑːhəm
घराना	ɡʱərɑːnɑː
एकजातीय	ekd͡ʒɑːtiːj
उभि	ubʱi
जिल्लाराम	d͡ʒillɑːrɑːm
स्वयंसेवक	svəjə̃sevək
पशुपक्षी	pəʃupəkʃiː
उत्तिको	uttiko
साहचर्य	sɑːhət͡ʃərj
कामधेनु	kɑːmdʱenu
विरगाथा	virgɑːtʰɑː
चन्द्रशेखर	t͡ʃəndrəʃekʰər
गुत्थि	gutʰʰi
आह्‍लाद	ɑːhlɑːd
नक्साल	n ʌ k s ä l
ढाल्	ɖʱ ä l
बरन्डा	b ʌ r ʌ n ɖ ä
उपाय	u p ä j
आमसञ्चार	ä m ʌ s ʌ n t͡ʃ ä r
जनशक्ति	d͡ʒ ʌ n ʃ ʌ k t̪ i
उमार्	u m ä r
ठूलाबडा	ʈʰ u l ä b ʌ ɖ ä
कलङ्की	k ʌ l ʌ ŋ k i
हाउस	ɦ ä u s
जिल्लाराम	d͡ʒ i l l ä r ä m
पग्लि	p ʌ ɡ l i
सुब्बा	s u b b ä
रमरमी	r ʌ m ʌ r m i
तड्कारै	t̪ ʌ ɖ k ä r ä i
विस्तारी	b i s t̪ ä r i
अनुगुण	ʌ n u ɡ u n
वाचकी	b ä t͡ʃ ʌ k i
पञ्चायत	p ʌ n t͡ʃ ä j ʌ t̪
बेच्	b e t͡ʃ
पिँद्	p i n d̪
खुल्कि	kʰ u l k i
सिट्	s i ʈ
झगड्याहा	d͡ʒʱ ʌ ɡ ʌ d̪ j ä ɦ ä
बड्‍कौँलो	b ʌ ɖ k ä ũ̯ l o
कसूरदार	k ʌ s u r d ä r
ताउली	t ä u l i
पतलाउ	p ʌ t̪ ʌ l ä u
माने	m ä n e
महिष	m ʌ ɦ i s
होचि	ɦ o t͡ʃ i
भूमण्डल	bʱ u m ʌ n ɖ ʌ l
पन्याइ	p ʌ n j ä i
मीनपचास	m i n p ʌ t͡ʃ ä s
गफ	ɡ ʌ f
गहत	ɡ ʌ ɦ ʌ t̪
केही	k e ɦ i
कार्यशैली	k ä r j ʃ ä i l i
छ्याट्ट	t͡ʃʰ j ä ʈ ʈ
एक्युपङ्चर	e k j u p ʌ ŋ t͡ʃ ʌ r
जाडे	d͡ʒ ä ɖ e
ढैंचा	ɖʱ ä i n t͡ʃ ä
अफिम	ʌ f i m
फलैँचा	f ʌ l ä i n t͡ʃ ä
हेलछेक्‍र्याइँ	ɦ e l t͡ʃʰ e k r j ä i n
रैती	r ä i t̪ i
लहना	l ʌ ɦ ʌ n ä
कसजू	k ʌ s ʌ d͡ʒ u
अर्घौतो	ʌ r ɡʱ ä u t̪ o
मनोविज्ञान	m ʌ n o b i d͡ʒ ʌ n ä n
हुर्रि	ɦ u r r i
पीडा	p iː ɖ aː
झुरुमुरु	d͡ʒʱ u r u m u r u
अशास्त्रीय	ʌ ʃ aː ʃ t̪ r iː j
मङ्गोल	m ŋ ɡ o l
आरिस	aː r i s
धपेड्	d̪ʱ p e ɖ
वाहन	w aː ɦ n
निक्ल	n i k l
खेर्	kʰ e r
उत्तिको	u t̪ t̪ i k o
प्यारा	p j aː r aː
धुरी	d̪ʱ u r iː
उभि	u bʱ i
बङ्गला	b ŋ ɡ l aː
बिजाइँ	b i d͡ʒ aː ĩ
कपी	k p iː
अठन्नी	ʌ t̪ʰ n n iː
आग्ले	aː ɡ l e
बाइकार्बोनेट	b aː i k aː r b o n e t̪
जातपतित	d͡ʒ aː t̪ p t̪ i t̪
बेल्ट	b e l t̪
कुशलता	k u ʃ l t̪ aː
लाजवती	l aː d͡ʒ w t̪ iː
चुड्का	t͡ʃ u ɖ k aː
बटुको	b ʈ u k o
छटपटी	t͡ʃʰ ʈ p ʈ iː
उपविष्ट	u p w i ʂ ʈ
अरिनी	ʌ r i n iː
सनातन	s n aː t̪ n
जिस्क	d͡ʒ i s k
हड्डी	ɦ ɖ ɖ iː
साङ्ली	s aː ŋ l iː
अयौन	ʌ j o n
फुटर	f u ʈ r
अतिक्रमण	ʌ t̪ i k r m ɳ
कुटुम्बी	k u ʈ u m b iː
बोको	b o k o
सेवन	s e w n
हकदार	ɦ k d aː r
खिपुवा	kʰ i p u w aː
खोसेल्टि	kʰ o s e l t̪ i
लग्न	l ɡ n
युगवाणी	j u ɡ w aː ɳ iː
रल्लि	r l l i
प्रेमकथा	p r e m k t̪ʰ aː
कार्बनडाइअक्साइड	k aː r b n ɖ aː i ʌ k s aː i d̪
रसि	r s i
काम्रो	k aː m r o
फर्छि	f r t͡ʃʰ i
चिप्ल	ʧ i p l
घ्याम्पे	ɡʱ j ä m p e
गर्माउ	ɡ ʌ r m ä u
झ्याप्लो	d͡zʱ j ä p l o
विखण्डन	b i kʰ ʌ n̪ d̪ ʌ n
अफाल्	ʌ pʰ ä l
अभिजातवर्ग	ʌ bʱ i d͡z ä t̪ ʌ b ʌ r ɡ
आसत्ति	ä s ʌ t̪ t̪ i
झट्याक	d͡zʱ ʌ t̪ j ä k
लिपु	l i p u
वायुमण्डल	b ä j u m ʌ n̪ d̪ ʌ l
मन्दी	m ʌ n̪ d̪ i
सिनेमा	s i n e m ä
दर्को	d̪ ʌ r k o
ओल्ट	o l ʈ
बर्मा	b ʌ r m ä
कर्कट	k ʌ r k ʌ ʈ
हुत्त	ɦ u t̪ t̪
छ्याकटे	t͡sʱ j ä k ʌ ʈ e
तीस	t̪ i s
मोर्चा	m o r t͡ʃ ä
बाइनरी	b ä i n ʌ r i
ठेक्‍का	ʈʰ e k k ä
पुलिस	p u l i s
आविष्ट	ä b i s̪ t̪
तथा	t̪ ʌ t̪ʰ ä
सबार	s ʌ b ä r
राममन्दिर	r ä m ʌ n̪ d̪ i r
हल्ट	ɦ ʌ l ʈ
श्यार्पा	ʃ j ä r p ä
खुसहाल	kʰ u s ʌ ɦ ä l
प्रतिदिन	p r ʌ t̪ i d̪ i n
वहि:	b ʌ ɦ i
अधिवक्ता	ʌ d̪ʱ i b ʌ k t̪ ä
बिन्	b i n
कपासे	k ʌ p ä s e
शुक्र	ʃ u k r
तत्पश्चात्	t̪ ʌ t̪ p ʌ ʃ t̪ʃ ä t̪
टमटम	ʈ ʌ m ʈ ʌ m
सम्पूर्णता	s ʌ m p u r n̪ t̪ ä
उद्‌बोधक	u d̪ b o d̪ʱ ʌ k
अट्टालिका	ʌ ʈ ʈ ä l i k ä
अयौन	ʌ j o u n
जाँघवाल	d͡z ä̃ ɡʱ b ä l
गन्धिलो	ɡ ʌ n̪ d̪ʱ i l o
आशौची	ä ʃ o u t͡ʃ i
शौरसेन	ʃ o u r ʌ s e n
उहुँ	u ɦ ũ
उतर्सि	u t̪ ʌ r s i
उपलब्धता	u p ʌ l ʌ bʱ d̪ʱ ʌ t̪ ä
दुङदुङ	d̪ʊŋd̪ʊŋ
रैती	ɾaɪt̪i
त्रिवेणी	t̪ɾɪveɳi
हिन्दी	ɦɪnd̪i
जगर्सेठ	d͡ʒʌɡʌɾset̪ʰ
देवेन्द्र	d̪eveɳd̪ɾʌ
विकल्प	vɪkʌlp
तौलसमूह	t̪aʊlsʌmuːɦ
द्रब्यशाह	d̪ɾʌbʌjɑːɦ
मोल	moːl
पुकपाक	pʊkpɑːk
जनस्तर	d͡ʒʌnʌst̪ʌɾ
अव्यय	ʌvʌjʌj
सल	sʌl
वेद	veːd̪
उपास्	ʊpɑːs
प्रभात	pɾʌbʌɑːt̪
आश्चर्यित	ɑːʃt͡ʃʌɾʌjit̪
अतिशय	ʌt̪ɪʃʌj
शान्तिवार्ता	ʃɑːnt̪ɪvɑːɾt̪ɑː
आतस	ɑːt̪ʌs
हप्कीदप्की	ɦʌpkɪd̪ʌpkɪ
साहचर्य	sɑːɦʌt͡ʃʌɾʌj
रुझ्	ɾʊd͡ʒʰ
पद	pʌd̪
मढ्	mʌd̪ʰ
सायुज्य	sɑːjuːd͡ʒʌj
पन्त	pʌnt̪
काव्यशैली	kɑːvʌjʃaɪli
तरक्की	t̪ʌɾkki
वाहन	vɑːɦʌn
पचपच	pʌt͡ʃpʌt͡ʃ
टल्ल	t̪ʌll
झँटाइ	d͡ʒʰʌ̃t̪ɑːi
बाहु	bɑːɦu
चौटा	t͡ʃaʊt̪ɑː
बेल्ट	beːlt̪
अथक	ʌt̪ʰʌk
अन्तरी	ʌnt̪ʌɾi
स्तरीयता	st̪ʌɾijʌt̪ɑː
अद्यतन	ʌd̪ʌjʌt̪ʌn
परिपाठ	pʌɾipɑːt̪ʰ
अधीन	ʌd̪ʱiːn
जाँघवाल	d͡ʒɑːŋɦvɑːl
दपेट्	d̪ʌpet̪
जत्ति	d͡ʒʌt̪t̪i
गर्भपाती	ɡʌɾbʌpɑːt̪i
क्रिकेट	kɾɪket̪
प्रवर्तन	pɾʌvʌɾt̪ʌn
ठकठकी	t̪ʰʌkʌt̪ʰʌki
टेस्ट	ʈesʈ
आइडल	ɑːiɖəl
झेलाहा	d͡ʒʱeːlɑːɦɑː
चड्कन	t͡ʃəɖkən
अनिष्ट	əniʂʈ
सद्‌गुरु	sədɡuru
डबल	ɖəbəl
अविकल	əvikəl
बुढिया	buɖʱijɑː
औताउ	ɔːtɑːu
केटाकेटी	keːʈɑːkeːʈiː
चिरचिरे	t͡ʃirət͡ʃire
तकदिर	təkədir
फट्याङ्ग्रा	pʰəʈjɑːŋgrɑː
एकसट्ठीऔं	ekəsəʈʰiːɔ̃
र्‌याँर्याँ	rjɑ̃ːrjɑ̃ː
अर्थात्	ərtʰɑːt
अपेक्षणीय	əpekʃəɳijə
असांसद	əsɑ̃ːsəd
टुक्रा	ʈukrɑː
बागवानी	bɑːɡvɑːniː
डेरी	ɖeːriː
कुलो	kulo
अफाल्	əpʰɑːl
प्रसन्न	prəsənnə
बिजुवा	bid͡zuvɑː
मौका	mɔːkɑː
ब्राम्हण	brɑːmʱəɳ
चाप्	t͡ʃɑːp
अमारो	əmɑːro
माहुर	mɑːɦur
नीम	niːm
ठाउँठाउँ	ʈʰɑ̃ʊ̯ʈʰɑ̃ʊ̯
पराग	pərɑːɡ
पञ्चायत	pəɲt͡ʃɑːjət
झ्याली	d͡ʒʱjɑːliː
चुड्का	t͡ʃuɖkɑː
अजङ	əd͡zəŋ
आराम	ɑːrɑːm
बैङ्कक	bɛ̃ŋkək
छादित	t͡ʃʰɑːdit
कोटे	koʈe
विबाह	vibɑːɦ
अनिन्द्य	ənindjə
मनिब्याग	mənibjɑːɡ
खेर्	kʰer
झुत्रेझाम्रे	d͡ʒʱutrɛd͡ʒʱɑːmre
प्रेम	prem
लठाङ्ग्रि	ləʈʰɑːŋgri
द्विपद	dvipəd
खोदल्	kʰo.d̪əl
उल्टोसुल्टो	uɭʈosulʈo
रामनारायण	rɑːm.nɑː.rɑː.jɑːɳ
हिरन	hi.rən
गबुल्लो	gə.bul.lo
सल	səl
बलि	bə.li
कुमारीपन	kumɑː.riː.pən
कुरकुर	kur.kur
दम्क	dəm.kə
भाक्	bʰɑːk
घरजम	gʰər.jəm
जुनाफ	junɑːf
क्लर्क	klərk
शव	ʃəv
हल्ट	həlʈ
सिलाबर	silɑː.bər
पूँजीपति	puːɳ.d͡ʒiː.pə.t̪i
पूर्णिमा	puːrɳimɑː
आहान	ɑː.hɑːn
सबथोक	səb.ʈʰok
दगुराइ	də.gurɑːi
गौँठली	gɔ̃ʈʰ.liː
जेठान	d͡ʒeː.ʈʰɑːn
धर्सो	d̪ʱər.so
पत्रकारिता	pət̪r.kɑː.ri.t̪ɑː
फ्यार्र	fjɑːr
रुपान्तरण	rupɑːn.t̪ər.ɳ
दावा	dɑː.vɑː
हुत्त	hut̪.t̪ə
मर्म	mər.mə
अप्रतिद्वन्द्व	əprə.t̪i.d̪ʋən.d̪ʋə
मीठो	miː.ʈʰo
घत्रक्क	gʰət̪rək.kə
खुलुल्ल	kʰul.ul.lə
अविजित	əvi.d͡ʒi.t̪
बलात्कार	bəlɑːt̪.kɑːr
उपदेशक	upə.d̪e.ʃək
ट्याम्पो	ʈjɑːm.po
मुख्यालय	mukʰ.jɑː.ləj
हुम्ला	hum.lɑː
उपहास	upə.hɑːs
अङ्गुलिका	əŋ.gul.i.kɑː
हरिभक्त	həri.bʰək.t̪
पक्कै	pək.kɑːi
धनेस	d̪ʱən.es
अवतीर्ण	əvə.t̪iːrɳ
काव्यचेतना	kɑːv.jə.t̪ʃe.t̪ənɑː
अविचलित	əvi.t̪ʃəl.i.t̪
काम्रो	kɑːm.ro
गन्थन	ɡʌn̪t̪ʰʌn
भण्डारी	bʱʌɳɖäːriː
गवेषी	ɡʌʋeːʂiː
ब्यानर	bjäːnʌr
नागर	näːɡʌr
हत्याकाण्ड	ɦʌt̪jäːkäːɳɖ
तिहुन	t̪iɦun
जोसदार	ɟosʌdäːr
जर्कि	ɟʌrki
अभिवन्दनीय	ʌbʱiʋʌn̪d̪ʌniːj
ल्यापल्यापती	ljäːpljäːpʌt̪iː
महिना	mʌɦinäː
बिख	bikʰ
कान्छी	käːn̪tʃʰiː
गन्धिलो	ɡʌn̪d̪ʱilo
डट	ɖʌʈ
अविजित	ʌʋiɟit̪
डिबडिब	ɖibɖib
पाउन्ड	päːunɖ
जप	ɟʌp
खुराफाती	kʰuräːpʰäːt̪iː
चन्द्रमुखी	tʃʌn̪d̪rʌmukʰiː
पुरुष	purʊʂ
गायब	ɡäːjʌb
अकथित	ʌkʌt̪ʰit̪
सिलेट	silet̪
मुसुक्क	musʊkː
पत्तोफाँट	pʌt̪t̪ofä̃ːʈ
थिच्	t̪ʰitʃ
झ्यालखाना	ɖʒʰjäːlʌkʰänäː
भरोसा	bʱʌrosäː
हारगुहार	ɦärɡʊɦär
असन्तोकी	ʌsʌn̪t̪oːkiː
लौत	lɔːt̪
प्यारा	pjäːräː
खिपुवा	kʰipʊʋäː
डाँड्	ɖä̃ːɖ
दम्क	d̪ʌmk
हाडछाला	ɦäːɖʧʰäläː
चुड्का	tʃʊɖkäː
धुकधुक	d̪ʱʊkʌd̪ʱʊk
विचारधारा	ʋitʃäːrʌd̪ʱäräː
त्रिशक्ति	t̪riːʃʌkt̪i
मुसलमान	musʌlʌmän
पुतौरो	put̪ɔːro
कीटाणुनाशक	kiːʈäːɳʊnäːʂʌk
मैलि	mäːli
ढाल्	ɖʱäl
मनिब्याग	mʌnibjäːɡ
भोजराज	bʱoːɟʌräːɟ
चमत्कार	t͡ʃ ʌ m ʌ t̪ k ä r
तिब्बत	t̪ i b b ʌ t̪
हिरन	ɦ i r ʌ n
घृणास्पद	ɡʱ ɾ i n ä s p ʌ d̪
स्याल्ल	s j ä l l
अनूढा	ʌ n u ɖʱ ä
उबडखाबड	u b ɖ ʌ kʰ ä b ɖ
पुरस्कार	p u r ʌ s k ä r
गुन्डा	ɡ u n ɖ ä
क्षोभक	k ʂ o bʱ ʌ k
अलग	ʌ l ʌ ɡ
चूनढुङ्गो	t͡ʃ u n ɖʱ u ŋ ɡ o
सिँगारु	s i ŋ ä r u
चुतिया	t͡ʃ u t̪ i j ä
बाण	b ä ɳ
अविघात	ʌ b i ɡʱ ä t̪
हेरविचार	ɦ e r ʌ b i t͡ʃ ä r
अविपन्न	ʌ b i p ʌ n n
जीन	d͡ʒ i n
शिश्‍न	ʃ i ʃ n
गर्	ɡ ʌ r
कुँवर	k u ŋ ʌ r
कुचेष्टा	k u t͡ʃ e ʂ ʈ ä
सानदार	s ä n ʌ d ä r
आदर	ä d̪ ʌ r
व्यतिरेक	b j ʌ t̪ i r e k
उछिनपाछिन	u t͡ʃ i n ʌ p ä t͡ʃ i n
तार्	t ä r
अङ्खोरा	ʌ ŋ kʰ o r ä
जरुर	d͡ʒ ʌ r u r
लुइँलुइँ	l u i ŋ l u i ŋ
सहायता	s ʌ ɦ ä j ʌ t̪ ä
पूँजीपति	p u ŋ d͡ʒ i p ʌ t̪ i
आविद्ध	ä b i d̪ʱ
बड्‍कौँलो	b ʌ ɖ k ä ŋ l o
इच्छुक	i t͡ʃʰ u k
आदी	ä d̪ i
उत्तेजन	u t̪ t̪ e d͡ʒ ʌ n
लालसा	l ä l s ä
प्रशंसापत्र	p r ʌ ʂ ʌ̃ s ä p ʌ t̪ r
झङ्कारित	d͡ʒʱ ʌ ŋ k ä r i t̪
कठोरपन	k ʌ ʈʰ o r p ʌ n
अपेक्षणीय	ʌ p e k ʂ ʌ ɳ i j
ड्वाङङ्वाङ	ɖ w ä ŋ ŋ w ä ŋ
उत्केन्द्र	u t̪ k e n d̪ r
यता	j ʌ t̪ ä
छोला	t͡ʃʰ o l ä
अगस्त्य	ʌ ɡ ʌ s t̪ j
अनिता	ʌ n i t̪ ä
कह	k ʌ ɦ
हडक्	ɦʌɖʌk
अतुलनीय	ʌt̪ulʌniːj
सिक्री	sikriː
निक्ल	niklʌ
मार्फत	mɑːɾpʰʌt̪
उम्र	umɾʌ
ट्रेडिङ	ʈɾeːɖiŋ
सम्पूर्णता	sʌmpuːɾɳʈʌ
खपटि	kʰʌpʌʈi
बालाजु	bɑːlɑːd͡ʒu
मकमक	mʌkʌmʌk
पशुपक्षी	pʌʂupʌkʂiː
इन्कार	iːnkɑːɾ
असुरक्षा	ʌsuɾʌkʂɑː
हाक्कहुक्क	ɦɑːkkʌɦukkʌ
तोड	ʈoːɖ
असबल्ले	ʌsʌbʌlleː
समाचारदाता	sʌmɑːt͡ʃɑːɾʌdɑːt̪ɑː
होड	ɦoːɖ
लमिलस्ट	lʌmilʌsʈ
झोक्का	d͡ʒʰoːkkɑː
बिन्	bin
बिन्ती	bint̪iː
अकथनिय	ʌkʌt̪ʰʌniːj
ढाक्रे	ɖʱɑːkɾeː
पहिचान्	pʌɦit͡ʃɑːn
लप्रक्क	lʌpɾʌkkʌ
कुहिरे	kʌɦiɾeː
भावक	bʱɑːʋʌk
ऐँचाताना	ɛ̃t͡ʃɑːt̪ɑːnɑː
झिँजोल्	d͡ʒʰĩd͡ʒol
हरफ	ɦʌɾʌpʰ
अपकर्षक	ʌpʌkʌɾʂʌk
सुइरो	suiɾoː
जुरे	d͡ʒuɾeː
जैरे	d͡ʒɛːɾeː
आकाङ्क्षी	ɑːkɑːŋkʂiː
रोप्	ɾoːp
आयुष्मान	ɑːjuʂmɑːn
जातपतित	d͡ʒɑːt̪ʌpʌt̪it̪
लोति	loːt̪i
ट्रस्ट	ʈɾʌsʈ
बोतो	boːʈoː
विद्यार्जन	ʋid̪jɑːɾd͡ʒʌn
तड्प	t̪ʌɖpʰ
हाँक्	ɦɑːŋk
चरित्रप्रधान	t͡ʃʌɾit̪ɾʌpɾʌd̪ʱɑːn
सुनुवार	sunuʋɑːɾ
चौतर्फी	t͡ʃɔːt̪ʌɾpʰiː
कामधेनु	kɑːmʌd̪ʱeːnu

    प्राचीनता	p ɾ aː t͡ʃ iː n ʈ aː
अमौलिक	ʌ m ɔː l i k
छिपाउ	t͡ʃʰ i p aː u
हड्डी	ɦ ʌ ɖː iː
विकार	ʋ i k aː r
पेट्रोलपम्प	p eː ʈ r oː l p ʌ m p
अकर्मण्यता	ʌ k ʌ r m ʌ ɳ j ʌ t aː
छकि	t͡ʃʰ ʌ k i
उच्छल	u t͡ʃʰ ʌ l
सुजाक	s u d͡ʒ aː k
सङ्गीन	s ʌ ŋ ɡ iː n
घुइँकि	ɡʱ u ĩ k i
निम्की	n i m k iː
वृद्ध	ʋ ɾ ɪ d̪ː ʌ
डुँड	ɖ ũ ɖ
उमङ्ग	u m ʌ ŋ ɡ
पानीजहाज	p aː n iː d͡ʒ ʌ ɦ aː d͡ʒ
जर्मनी	d͡ʒ ʌ r m ʌ n iː
कलकलाउँदो	k ʌ l k ʌ l aː ũ d o
फुर्ती	pʰ u r t iː
भुँडल्लो	bʱ ũ ɖ ʌ l l o
मङ्गलाचरण	m ʌ ŋ ɡ ʌ l aː t͡ʃ ʌ r ʌ n
अहल्या	ʌ ɦ ʌ l j aː
नीम	n iː m
पिरीपिरी	p i r iː p i r iː
बाथटब	b aː tʰ ʈ ʌ b
लुटि	l u ʈ i
रेखाचित्र	r eː kʰ aː t͡ʃ i t̪ r
उखान	u kʰ aː n
आघौँ	aː ɡʱ aʊ̃
मिलीजुली	m i l iː d͡ʒ u l iː
निराश	n i r aː ʃ
घुलित	ɡʱ u l i t̪
आरोप्य	aː r oː p j ʌ
द्विपद	d̪ ʋ i p ʌ d̪
वाङ्‍मय	ʋ aː ŋ m ʌ j
फेचो	pʰ eː t͡ʃ o
फलाक्	pʰ ʌ l aː k
दुर्गादास	d̪ u r ɡ aː d̪ aː s
जुस	d͡ʒ u s
अञ्चल	ʌ ɲ t͡ʃ ʌ l
चिमचिम	t͡ʃ i m ʌ t͡ʃ i m
दगुराइ	d̪ ʌ ɡ u r aː i
वायुसेना	ʋ aː j u s eː n aː
लाग्	l aː ɡ
कान्ड	k aː n ɖ
मौका	m aʊ k aː
उत्तान	u t̪ t̪ aː n
बनेल	b ʌ n eː l
उछिनपाछिन	u t͡ʃʰ i n ʌ p aː t͡ʃʰ i n

    लाद्	lɑːd
लाजवती	lɑːd͡ʒʋətiː
आयुक्त	ɑːjʊkt̪
गर्भपाती	ɡərbʱpɑːtiː
टोकाइ	ʈoːkɑːi
आखिरी	ɑːkʰiriː
अमानव	əmɑːnəʋ
ग्वाँगे	ɡʋɑ̃ːɡeː
अभङ्ग	əbʱəŋɡ
ङ्वासङ्वास	ŋʋɑːsəŋʋɑːs
उच्छन्न	ʊt͡ʃʰənn
साढु	sɑːɖʱʊ
जीउपाला	d͡ʒiːʊpɑːlɑː
बत्ताउ	bəttɑːʊ
पावरनाथ	pɑːʋərnɑːtʰ
डिसेम्बर	ɖisembər
उखाड्	ʊkʰɑːɖ
दपेटाइ	dəpet̪ɑːi
थुप्रा	tʰʊprɑː
बुरुण्डी	bʊruːɳɖiː
सुनार	sʊnɑːr
लतलती	lətələtiː
उकुसमुकुस	ʊkʊsəmʊkʊs
प्रालेख	prɑːlekʰ
बग्रेन	bəɡren
निस्कासन	niskɑːsən
भतभती	bʱət̪əbʱətiː
अनिच्छा	ənit͡ʃʰɑː
दधीचि	dədʱiːt͡ʃi
जब	d͡ʒəb
लोग्नेमानिस	loːɡnemɑːnis
ताण्डव	tɑːɳɖəʋ
ढिम्री	ɖʱimriː
हग्	ɦəɡ
लुटपुट	lʊʈpʊʈ
बरफ	bərəf
कखौतो	kəkʰɔːt̪oː
कृतवीर्य	kɾit̪ʋiːrjə
रजिस्ट्रार	rəd͡ʒist̪rɑːr
देवदेवी	d̪eʋd̪eʋiː
भरणपोषण	bʱərəɳpoːʂəɳ
हीरामणि	ɦiːrɑːməɳi
मङ्गोल	məŋɡoːl
रुगरुगी	rʊɡərʊɡiː
जीवत्‌पतिका	d͡ʒiːʋətpət̪ikɑː
कोठा	koːʈʰɑː
साँप्रो	sɑ̃ːproː
कपी	kəpiː
धरौटी	dʱərɔːʈiː
चहार	t͡ʃəɦɑːr

    ओसि	o s i
उखान	u kʰ a n
ख्याति	kʰ j a t i
न्यायाधीश	n j a j a dʱ i ʃ
ढुङ्गो	ɖʱ u ŋ g o
कुटी	k u ʈ i
हारहुर	ɦ a r ɦ u r
डिपोट	ɖ i p o ʈ
दपेटाइ	d a p e ʈ a i
छूताछूत	t͡ʃʰ u t a t͡ʃʰ u t
वायुसेना	v a j u s e n a
सारुप्य	s a r u p j a
रघुवीर	r a ɡʱ u v i r
खर्याङखुरुङ	kʰ a r j a ŋ kʰ u r u ŋ
तमोर	t a m o r
घोचिलो	ɡʱ o t͡ʃ i l o
सङ्ग्राम	s a ŋ g r a m
हेलछेक्‍र्याइँ	ɦ e l t͡ʃʰ e k r j a ĩ
बङ्गला	b a ŋ g l a
पूर्णविराम	p u r ɳ a v i r a m
रचनाकार	r a t͡ʃ a n a k a r
वैल	v a i l
कहीं	k a ɦ ĩ
विचलन	v i t͡ʃ a l a n
एन	e n
खराब	kʰ a r a b
बक्रम	b a k r a m
विकास	v i k a s
बेगल	b e g a l
पक्राउ	p a k r a u
चोरऔंले	t͡ʃ o r a ũ l e
कान्ड	k a n ɖ
रायमाझी	r a j a m a d͡zʱ i
पञ्चायत	p a ɲ t͡ʃ a j a t
ड्वाङ्ग	ɖ v a ŋ g
किट्	k i ʈ
कर्कशता	k a r k a ʃ a t a
सितमणि	s i t a m a ɳ i
वेदाङ्ग	v e d a ŋ g
वाचकी	v a t͡ʃ a k i
प्रजा	p r a d͡z a
तानाशाह	t a n a ʃ a ɦ
हुप	ɦ u p
मुख्यालय	m u kʰ j a l a j
गिरावट	g i r a v a ʈ
आर्य	a r j a
अर्बुद	a r b u d
उम्ट	u m ʈ
आक्षेपक	a kʃ e p a k
सिठो	s i ʈʰ o

    प्राविधिक	p ɾ aː v i d̪ʱ i k
भित्र	bʱ i t̪ ɾ
चम्के	t͡ʃ ʌ m k e
सबार	s ʌ b aː ɾ
अर्घौतो	ʌ ɾ gʱ aʊ t̪ o
बुढिया	b u ɖʱ i j aː
गजेटेड	ɡ ʌ d͡ʒ eʈ eɖ
अतुल	ʌ t̪ u l
कराई	k ʌ ɾ aː i
भरणपोषण	bʱ ʌ ɾ ʌ n p o ʂ ʌ n
अत्यावस्यकरुप	ʌ t̪ j aː v ʌ s j ʌ k ɾ u p
पृष्ठाङ्कन	p ɾ ʂ ʈʰ aː ŋ k ʌ n
सम्भ्रम	s ʌ m bʱ ɾ ʌ m
वेदाङ्ग	v e d aː ŋ ɡ
जेल	d͡ʒ e l
प्रतिपद	p ɾ ʌ t̪ i p ʌ d̪
आज	aː d͡ʒ
काटमार	k aː ʈ m aː ɾ
लताम	l ʌ t̪ aː m
धर्सो	d̪ʱ ʌ ɾ s o
प्रशस्त	p ɾ ʌ ʂ ʌ s ʈ
भुँडल्लो	bʱ ũ ɖ ʌ l l o
बर्खा	b ʌ ɾ kʰ aː
गमनीय	ɡ ʌ m ʌ n i j ʌ
सुनुवाइ	s u n u v aː i
अनुत्पादक	ʌ n u t̪ p aː d̪ ʌ k
दुवाकोट	d̪ u v aː k o ʈ
गोत्र	ɡ o t̪ ɾ
प्याकुरेल	p j aː k u ɾ e l
अद्यपि	ʌ d̪ j ʌ p i
अभिजातवर्ग	ʌ bʱ i d͡ʒ aː t̪ v ʌ ɾ ɡ
बिलौना	b i l aʊ n aː
फट्याङ्ग्रो	pʰ ʌ ʈ j aː ŋ ɡ ɾ o
निखार	n i kʰ aː ɾ
एकसट्ठी	e k s ʌ ʈ ʈʰ iː
एक्काईस	e k k aː iː s
अन्ताक्षरी	ʌ n t̪ aː kʂ ʌ ɾ iː
उत्क्रमण	u t̪ k ɾ ʌ m ʌ n
धाई	d̪ʱ aː i
हिमचुली	ɦ i m ʌ t͡ʃ u l iː
बोतो	b o t̪ o
केर्	k e ɾ
गज्क	ɡ ʌ d͡ʒ k
काठ	k aː ʈʰ
बहस	b ʌ ɦ ʌ s
प्लेग	p l e ɡ
यती	j ʌ t̪ iː
अभिलक्षण	ʌ bʱ i l ʌ kʂ ʌ n
मट्टै	m ʌ ʈ ʈ aː i
जर्याक्क	d͡ʒ ʌ ɾ j aː k k
हाई-हाई	ɦaːi ɦaːi
अवहेलन	ʌʋʌɦeːlʌn
धादिङ	ɖʱaːɖiŋ
रुढी	ruɖʱiː
अलग	ʌlʌɡ
बाजि	baːd͡zi
जङ्गि	d͡zʌŋɡi
उपचारी	ʊpʌt͡ʃaːriː
उत्क्रमण	ʊtkrʌmʌɳ
चेकपोस्ट	t͡ʃeːkʌpoːst
झुप्पि	d͡ʒʌpːi
झिँजोल्	d͡ʒĩd͡zoːl
वाचस्पति	ʋaːt͡ʃʌspʌti
पदस्थापन	pʌdʌstʰaːpʌn
डाइनी	ɖaːiniː
मुख्तियार	mʊkʰtiːjaːr
खनाल	kʰʌnaːl
गमनीय	ɡʌmʌniːjʌ
छौँडा	t͡ʃʌ̃ɖaː
सिट्	siʈ
रल्लि	rʌlli
दङ्गा	dʌŋɡaː
झुर्र	d͡ʒʌrː
झिँगटो	d͡ʒĩɡʌʈoː
आदेशक	aːd̪eːʃʌk
ल्यापल्यापती	ljaːpljaːptiː
नीम	niːm
राजनेता	raːd͡ʒʌneːt̪aː
सानोठिमी	saːnoːʈʰimiː
दुलही	dʊlʌɦiː
फ्रेमसेट	pʰreːmseːʈ
ऋणदाता	ɽɪɳʌd̪aːt̪aː
छुद्र	t͡ʃʌd̪rʌ
उमङ्ग	ʊmʌŋɡ
लेफ्टिनेन्ट	leːpʰʈineːnʈ
प्रसार	prʌsaːr
अपुत	ʌpʊt̪
चर्चित	t͡ʃʌrt͡ʃiːt̪
अन्तर्विरोध	ʌnt̪ʌrʋiːroːd̪ʱ
समाह्‍वान	sʌmaːɦʋaːn
खुड्किलो	kʰʊɖkilo
ठकठकी	ʈʰʌkʈʰʌkiː
कलाबत्तु	kʌlaːbʌʈʈʊ
गार्डेन	ɡaːrɖeːn
आनन्दित	aːnʌnd̪iːt̪
सप्र्याक	sʌprjaːk
श्रीमान्	ʃriːmaːn
रोध	roːd̪ʱ
जगर्सेठ	d͡ʒʌɡʌrseːʈʰ
उल्क	ʊlk
माइक्रोप्रोसेसर	m aɪ k r o p r o s e s a r
कोफी	k o f i
जिस्क	j i s k
गन्धालु	g ʌ n dʱ a l u
भलभल	bʱ a l bʱ a l
प्रथमाक्षर	p r ʌ tʰ m a kʃ a r
एकत्र	e k ʌ t r
सन्न	s ʌ n n
जुत्त्याउ	j u t t j a u
भतभती	bʱ ʌ t bʱ a t i
निशिदिन	n i ʃ i d i n
अङ्कारा	ʌ ŋ k a r a
अठार	ʌ tʰ a r
आर्जे	a r j e
घुँक्क	ɡʱ u ŋ k
गव्य	g ʌ v j
मुख्तियार	m u kʰ t i j a r
बोर्डिङ	b o r d i ŋ
हुक्क	ɦ u k k
गुनगुन	g u n g u n
कार्यशैली	k a r j ʃ a i l i
सुलसुल	s u l s u l
भिउँट	bʱ i u ŋ t
क्लोरोफिल	k l o r o f i l
आशौच	a ʃ a u tʃ
क्रीम	k r i m
डन्ठा	d ʌ n tʰ a
भोटेचिया	bʱ o t e tʃ i j a
कुँड्	k u ŋ d
थिचो	tʰ i tʃ o
अरिनी	ʌ r i n i
कस्केली	k ʌ s k e l i
देवनागरी	d e v ʌ n a g a r i
टेलीभिजन	t e l i bʱ i j ʌ n
तिखार्	t i kʰ a r
छुरबुर	tʃʰ u r b u r
फोहरा	f o ɦ a r a
सुबोल	s u b o l
खोसेल्	kʰ o s e l
अरनी	ʌ r n i
पञ्चैती	p ʌ n tʃ a i t i
तिरतिरी	t i r ʌ t i r i
दगुराइ	d ʌ g u r a i
गुँगो	g u ŋ g o
हाँक्	ɦ a ŋ k
आँखालाग्दो	a ŋ kʰ a l a g d o
डाँडाकाँडा	d a ŋ d a k a ŋ d a
भगवान	bʱ ʌ g ʌ v a n
पटेर	p ʌ t e r
पनौती	p ʌ n a u t i

    सहायता	s ʌ ɦ ä j ʌ t̪ ä
साँप्रो	s ä̃ p r o
जकडबन्द	d͡ʒ ʌ k ʌ d̪ b ʌ n̪ d̪
टुक्रि	ʈ u k r i
बदाम	b ʌ d ä m
कोठा	k o ʈʰ ä
डँड्याउ	ɖ ä̃ ɖ j ä u
लाउ	l ä u
जफत	d͡ʒ ʌ f ʌ t̪
पम्फा	p ʌ m pʰ ä
जुनार	d͡ʒ u n ä r
उपहासक	u p ʌ ɦ ä s ʌ k
रहनसहन	r ʌ ɦ ʌ n̪ s ʌ ɦ ʌ n̪
जाडे	d͡ʒ ä ɖ e
ककनी	k ʌ k ʌ n i
छडछड	t͡sʰ ʌ ɖ t͡sʰ ʌ ɖ
अस्वीकृति	ʌ s b i k ɾ i t̪ i
झुप्पि	d͡zʱ u p p i
अर्बुद	ʌ r b u d̪
फलाक्	pʰ ʌ l ä k
जोकर	d͡ʒ o k ʌ r
राधेश्याम	r ä d̪ʱ e ʃ j ä m
लेखपढ	l e kʰ p ʌ ɖʱ
विनोदकुमार	b i n o d̪ ʌ k u m ä r
पहल	p ʌ ɦ ʌ l
पक्कै	p ʌ k k ä i
उभयनिष्ठ	u bʱ ʌ j ʌ n i ʂʈʰ
धिक्कार	d̪ʱ i k k ä r
अमानुष	ʌ m ä n u ʂ
लिपित्त	l i p i t̪ t̪
सिँङार	s i ŋ ä r
पजेरो	p ʌ d͡ʒ e r o
पालनपोषण	p ä l ʌ n̪ p o ʂ ʌ n̪
प्रयोगविधि	p r ʌ j o ɡ ʌ b i d̪ʱ i
आहाल	ä ɦ ä l
शान्त	ʃ ä n̪ t̪
उत्क्रमण	u t̪ k r ʌ m ʌ n̪
लागिमेली	l ä ɡ i m e l i
छेकुवा	t͡sʰ e k u w ä
बोतो	b o t̪ o
निम्की	n i m k i
अतुल	ʌ t̪ u l
अनुशासित	ʌ n u ʃ ä s i t̪
ग्वाँगे	ɡ w ä̃ ɡ e
सिदा	s i d̪ ä
दुवाकोट	d̪ u w ä k o ʈ
पुँजी	p ũ d͡ʒ i
घनश्याम	ɡʱ ʌ n ʃ j ä m
वाङ्‍मय	b ä ŋ m ʌ j
खैँच	kʰ ä̃ t͡s
घराना	ɡʱ ə r ɑː n ɑː
खपटि	kʰ ə p ʌ ʈ i
थाप्	ʈʰ ɑː p
सत्कार	s ə t̪ k ɑː r
कुर्ची	k ʊ r tʃ iː
यान	j ɑː n
जलमग्न	d͡ʒ ə l m ə ɡ n̪
सुकुटे	s ʊ k ʊ ʈ eː
कत्थक	k ə t̪ʰ t̪ʰ ə k
ताली	t̪ ɑː l iː
अरगज्ज	ə r ə ɡ d͡ʒ ə d͡ʒ
पाठक	p ɑː ʈʰ ə k
सम्पात	s ə m p ɑː t̪
आहाल	ɑː h ɑː l
पोर्तगाल	p oː r t̪ ə ɡ ɑː l
पुतली	p ʊ t̪ ə l iː
प्रसिद्धि	p r ə s i d̪ʱ iː
चन्दने	tʃ ə n d̪ ə n eː
झ्याली	d͡ʒʱ j ɑː l iː
पलट्ट	p ə l ʌ ʈ ʈ
मनाङ	m ə n ɑː ŋ
त्रियाकलाप	t̪ r i j ɑː k ə l ɑː p
आँठो	ɑː ŋ ʈʰ oː
दर्शन	d̪ ə r ʃ ə n
कनिके	k ə n i k eː
बाहु	b ɑː h uː
आदि	ɑː d̪ i
दोकान	d̪ oː k ɑː n
सिक्	s i k
ताउली	t̪ ɑː ʊ l iː
वर्णन	b ə r ɳ ə n
इलेक्ट्रिसियन	i l eː k t̪ r i s i j ə n
कपोलकल्पित	k ə p oː l ə k ə l p i t̪
द्वित्व	d̪ ʋ i t̪ ʋ
फिर्क	pʰ i r k
हल	h ə l
व्रतालु	b r ə t̪ ɑː l uː
ग्रावा	ɡ r ɑː ʋ ɑː
उम्त्याहा	ʊ m t̪ j ɑː h ɑː
टेनिस	ʈ eː n i s
शिल्प	ʃ i l p
धनञ्जय	d̪ʱ ə n ə ɲ d͡ʒ ə j
प्रभा	p r ə bʱ ɑː
क्रमागत	k r ə m ɑː ɡ ə t̪
अमौलिक	ə m ɔː l i k
पन्याइ	p ə n j ɑː i
चाकडी	tʃ ɑː k ə d̪ iː
खोस्	kʰ oː s
ढेडु	ɖʱ eː d̪ ʊ
झिल्का	d͡ʒʱ i l k ɑː

    लतलती	l ʌ t l ʌ t i
छेकुवा	t͡sʰ e k u w ʌ
अपहरणकारी	ʌ p ʌ h ʌ r ʌ n k ʌ r i
प्रधान	p r ʌ dʱ ʌ n
महानिर्वाचन	m ʌ h ʌ n i r w ʌ t͡ʃ ʌ n
घुन्न	ɡʱ u nː
डीएनए	ɖ i e n e
धनुर्धर	dʱ ʌ n u r dʱ ʌ r
चर्	t͡ʃ ʌ r
मयूर	m ʌ j u r
लघुकाव्य	l ʌ ɡʱ u k ʌ w j ʌ
ख्यात	kʰ j ʌ t
यान	j ʌ n
किस्मती	k i s m ʌ t i
डच	ɖ ʌ t͡ʃ
सप्र्याक	s ʌ p r j ʌ k
तन	t ʌ n
चाटुकार	t͡ʃ ʌ t u k ʌ r
छोटे	t͡sʰ o t e
भँगडी	bʱ ʌ ŋ ɖ i
उतर्सि	u t ʌ r s i
झिँगो	d͡zʱ i ŋ o
अनपाम्मे	ʌ n ʌ p ʌ mː e
एकेक	e k e k
आमन्त्रित	ʌ m ʌ n t̪ r i t̪
चड्कन	t͡ʃ ʌ ɖ k ʌ n
तन्दा	t ʌ n d ʌ
ख्याति	kʰ j ʌ t i
ठ्यामठ्याम	ʈʰ j ʌ m ʈʰ j ʌ m
फ्याक्स	pʰ j ʌ k s
भित्र	bʱ i t̪ r
द्वितीया	d̪ w i t̪ i j ʌ
गोब्य्राउ	ɡ o b j r ʌ u
निकासी	n i k ʌ s i
फर्छ्योट	pʰ ʌ r t͡ʃʰ j o ʈ
किरिकिरी	k i r i k i r i
ओझेल	o d͡zʱ e l
घुँडे	ɡʱ u ɳ ɖ e
पार्टी	p ʌ r t i
चङ्गा	t͡ʃ ʌ ŋ ɡ ʌ
अविवेक	ʌ w i w e k
रीस	r i s
विदेशमन्त्री	w i d̪ e ʃ m ʌ n t̪ r i
घनटाउके	ɡʱ ʌ n ʈ ʌ u k e
सत्कार	s ʌ t̪ k ʌ r
उल्टाइ	u l ʈ ʌ i
कखौतो	k ʌ kʰ ʌ u t̪ o
सञ्चालिका	s ʌ n t͡ʃ ʌ l i k ʌ
घस्य्राहा	ɡʱ ʌ s j r ʌ h ʌ
घुस	ɡʱ u s

    लँगौटी	l ə̃ ŋ ɔ ʈ i
कठपाइले	k ʌ ʈʰ p ɑ i l e
भुक्लुक्क	bʱ ʊ k l ʊ k k
कपासे	k ʌ p ɑ s e
पुस	p ʊ s
हाउस	ɦ ɑ ʊ s
अपस्मार	ʌ p s m ɑ r
घडघडे	ɡʱ ʌ ɖ ɡʱ ʌ ɖ e
ड्वाङङ्वाङ	ɖʋ ɑ ŋ ŋ ʋ ɑ ŋ
पत्तोफाँट	p ʌ t t o f ɑ̃ ʈ
बगाल	b ʌ ɡ ɑ l
कलमजीवी	k ʌ l ʌ m dʒ i ʋ i
बुधुना	b ʊ dʱ ʊ n ɑ
चिहान	tʃ i ɦ ɑ n
सामियाना	s ɑ m i j ɑ n ɑ
चैत्र	tʃ ɛ t r
उछिल्ल्याहा	ʊ tʃʰ i l l j ɑ ɦ ɑ
मनोभावना	m ʌ n o bʱ ɑ ʋ n ɑ
अलौटो	ʌ l ɔ ʈ o
विमुढ	ʋ i m ʊ ɖʱ
छिपाउ	tʃʰ i p ɑ ʊ
गन्दगी	ɡ ʌ n d ʌ ɡ i
झुरो	dʒʱ ʊ r o
रातारात	r ɑ t ɑ r ɑ t
अवाञ्छनीय	ʌ ʋ ɑ ɲ tʃʰ n i j ʌ
कुचेष्टा	k ʊ tʃ e ʂ ʈ ɑ
विलक्षण	ʋ i l ʌ kʂ ʌ n
आधार	ɑ dʱ ɑ r
खिस्सा	kʰ i s s ɑ
अधिकृत	ʌ dʱ i k r ɪ t
लडाक	l ʌ ɖ ɑ k
नीम	n i m
हुस्सु	ɦ ʊ s s ʊ
गुत्थि	ɡ ʊ tʰ tʰ i
अत्यास	ʌ t j ɑ s
जर्कट	dʒ ʌ r k ʈ
दर्शन	d ʌ r ʃ ʌ n
कान्छी	k ɑ n tʃʰ i
सुर	s ʊ r
नाइटो	n ɑ i ʈ o
घोचुवा	ɡʱ o tʃ ʊ ʋ ɑ
सहसेनानी	s ʌ ɦ s e n ɑ n i
बाउँडि	b ɑ ʊ̃ ɖ i
युगौँ	j ʊ ɡ ɔ̃
अफाल्	ʌ f ɑ l
च्वाँक	tʃʋ ɑ̃ k
ठक्‍कर	ʈʰ ʌ k k ʌ r
टेस्ट	ʈ e s ʈ
खसोखास	kʰ ʌ s o kʰ ɑ s
टुङ्‍ना	ʈ u ŋ n ɑ
गिज्ज	ɡ i d͡z d͡z
अनुसार	ʌ n u s ɑː r
अडियल	ʌ ɖ i j ʌ l
फतर्को	pʰ ʌ t̪ ʌ r k o
विशालबजार	b i ʃ ɑː l b ʌ d͡z ɑː r
अज्ञेय	ʌ d͡z ɲ e j
आचमन	ɑː t͡ʃ m ʌ n
आत्मालोचना	ɑː t̪ m ɑː l o t͡ʃ ʌ n ɑː
सङ्ल	s ʌ ŋ l
गिरावट	ɡ i r ɑː b ʌ t̪
ल्वात्त	l w ɑː t̪ t̪
कुशासन	k u ʃ ɑː s ʌ n
एक्कासि	e k̚ k ɑː s i
चेन्ज	t͡ʃ e n d͡z
त्यता	t̪ j ʌ t̪ ɑː
मान्धाता	m ɑː n dʱ ɑː t̪ ɑː
अपुङ्गी	ʌ p u ŋ ɡ i
लेखापरीक्षण	l e kʰ ɑː p ʌ r iː kʃ ʌ n
उस्ताद	u s t̪ ɑː d
कपासे	k ʌ p ɑː s e
जीर्ण	d͡z iː r ɳ
चम्सुर	t͡ʃ ʌ m s u r
कुनो	k u n o
आशंसित	ɑː ʃ ʌ̃ s i t̪
बिछ्यौना	b i t͡ʃ j ɔː n ɑː
उग्रवाद	u ɡ r ʌ b ɑː d
लटपट	l ʌ t̪ p ʌ t̪
झाँगड	d͡zʱ ɑ̃ ɡ ʌ ɖ
मोसो	m o s o
अदालत	ʌ d ɑː l ʌ t̪
सारांश	s ɑː r ɑ̃ ʃ
सूची	s uː t͡ʃ i
चन्द्रमणि	t͡ʃ ʌ n d̪ r ʌ m ʌ ɳ i
देख्	d e kʰ
सती	s ʌ t̪ iː
पाण्डे	p ɑː ɳ ɖ e
पक्षी	p ʌ kʃ iː
सम्पुट	s ʌ m p u t̪
साढु	s ɑː ɖʱ u
सारुप्य	s ɑː r u p j ʌ
सुमर्	s u m ʌ r
भुक्लुक्क	bʱ u k l u k̚ k
झङ्कारित	d͡zʱ ʌ ŋ k ɑː r i t̪
धर्मपत्र	d̪ʱ ʌ r m ʌ p ʌ t̪ r
टकराउ	t̪ ʌ k ʌ r ɑː u
बिमाख	b i m ɑː kʰ
बतुरि	b ʌ t̪ u r i
बगली	b ʌ ɡ ʌ l i
अकथित	ʌ k ʌ t̪ʰ i t̪
मैनबत्ती	m ʌ i n ʌ b ʌ t̪ t̪ iː

    कल्याण	k ʌ l j ä̃
भर्सेला	bʱ ʌ r s e l ä
रातारात	r ä t ä r ä t
धूवाँ	dʱ u v ä̃
ख्याल	kʱ j ä l
बौद्धिकता	b aʊ dʱ i k ʌ t ä
अश्रान्त	ʌ s r ä n t̪
साँच्चै	s ä̃ t͡ʃ t͡ʃ ä i
इन्क्लाब	i n k l ä b
आशाकारी	ä s ä k ä r i
देख्	d e kʰ
सिँगारु	s ĩ ɡ ä r u
ल्याङ्ग्वेज	l j ä ŋ g w e d͡z
गबुल्लो	ɡ ʌ b u l l o
उझिन्ड्याउ	u d͡ʒʱ i n ɖ j ä u
क्वाइँक्वाइँ	k w ä ĩ k w ä ĩ
पास	p ä s
धुस्नि	dʱ u s n i
अवास्तविक	ʌ w ä s t̪ ʌ v i k
उल्टोसुल्टो	u l ʈ o s u l ʈ o
पुलुपुलु	p u l u p u l u
उँधो	ũ dʱ o
गल	ɡ ʌ l
अंशु	ʌ̃ s u
परपरि	p ʌ r p ʌ r i
जस	d͡z ʌ s
नीच	n i t͡ʃ
कत्रो	k ʌ t̪ r o
गोस्वारी	ɡ o s w ä r i
निजगढ	n i d͡z ɡ ʌ dʱ
कट्टरपन्थी	k ʌ ʈ ʈ ʌ r p ʌ n t̪ʰ i
चोक	t͡ʃ o k
स्क्यान	s k j ä n
थुँगा	t̪ʰ ũ ɡ ä
प्रेसिडेन्ट	p r e s i d e n ʈ
डाँड्	ɖ ä̃ ɖ
टाई	ʈ ä i
दोचा	d o t͡ʃ ä
गूढ	ɡ u ɖʱ
हुत्त	ɦ u t̪ t̪
याँ	j ä̃
अर्थात्	ʌ r t̪ʰ ä t̪
बाउँडि	b ä ũ ɖ i
लता	l ʌ t̪ ä
गुल्ट	ɡ u l ʈ
बेग्लि	b e ɡ l i
विश्लेषण	v i ʃ l e s ʌ n
चरी	t͡ʃ ʌ r i
छालि	t͡ʃʰ ä l i
चिरबिरे	t͡ʃ i r b i r e

    चूनढुङ्गो	t͡ʃ uː n ɖʱ u ŋ ɡ o
प्रालेख	p ɾ aː l e kʰ
उच्छल	u t͡ʃʰ ʌ l
अतिरथी	ʌ t̪ i ɾ ʌ t̪ʰ iː
रञ्जनादेवी	ɾ ʌ ɲ d͡ʒ ʌ n aː d eː ʋ iː
गन्धिलो	ɡ ʌ n d̪ʱ i l o
चपाती	t͡ʃ ʌ p aː t̪ iː
अज्ञेय	ʌ d͡ʒ ɲ eː j ʌ
सेप	s eː p
कम्ती	k ʌ m t̪ iː
शुद्धाशुद्धि	ʃ u d̪ʱ aː ʃ u d̪ʱ i
ह्रास	ɦ ɾ aː s
ऐँचाताना	ʌ ĩ t͡ʃ aː t̪ aː n aː
श्रेणी	ʃ ɾ eː ɳ iː
मेधा	m eː d̪ʱ aː
समेना	s ʌ m eː n aː
हेरविचार	ɦ eː ɾ ʋ i t͡ʃ aː ɾ
पसाँगि	p ʌ s aː ŋ i
अकर्मण्यता	ʌ k ʌ ɾ m ɳ j ʌ t̪ aː
गोस्वारी	ɡ o s ʋ aː ɾ iː
नर्सिंगहोम	n ʌ ɾ s i ŋ ɡ ʌ ɦ oː m
सुकुटे	s u k uʈ eː
बाथ	b aː t̪ʰ
धुस्नि	d̪ʱ u s n i
उत्तरदाता	u t̪ t̪ ʌ ɾ d aː t̪ aː
झुत्रेझाम्रे	d͡ʒʱ u t̪ ɾ eː d͡ʒʱ aː m ɾ eː
धातु	d̪ʱ aː t̪ u
काइँकुइँ	k aː ĩ k u ĩ
फारु	pʰ aː ɾ u
दोचा	d o t͡ʃ aː
अनरेरी	ʌ n ʌ ɾ eː ɾ iː
सुजाक	s u d͡ʒ aː k
टेस्ट	ʈ eː s ʈ
फागुन	pʰ aː ɡ u n
घुँक्क	ɡʱ u ŋ k
ज्वालामुखी	d͡ʒ ʋ aː l aː m u kʰ iː
जनशक्ति	d͡ʒ ʌ n ʃ ʌ k t̪ i
जुनार	d͡ʒ u n aː ɾ
केटाकेटी	k eː ʈ aː k eː ʈ iː
आला	aː l aː
पिनास	p i n aː s
थाप्	t̪ʰ aː p
उत्तप्त	u t̪ t̪ ʌ p t̪
दापा	d aː p aː
चम्सुर	t͡ʃ ʌ m s u ɾ
ओष्ठ्यदन्त्य	o ʂʈʰ j ʌ d̪ ʌ n t̪ j ʌ
मधुरो	m ʌ d̪ʱ u ɾ o
खनाल	kʰ ʌ n aː l
कुँवर	k u ŋ ʋ ʌ ɾ
खोल्सी	kʰ o l s iː
सपाट	s ʌ p ä ʈ
पुँजी	p ũ̯ d͡ʒ i
फ्याक्स	pʰ j ä k s
फ्वासफ्वास	pʰ w ä s pʰ w ä s
भरभित्तो	bʱ ʌ r bʱ i t̪ ʈ o
बरन्डा	b ʌ r n ɖ ä
हुर्रि	ɦ u r r i
जर्क	d͡ʒ ʌ r k
कागत	k ä ɡ ʌ t̪
गबुल्लो	ɡ ʌ b u l l o
सोपान	s o p ä n
वर्त्स्य	b ʌ r t̪ s j ʌ
मदिरा	m ʌ d i r ä
औस्या	ʌ u s j ä
चस्मदिद	t͡ʃ ʌ s m ʌ d i d
आफन्त	ä pʰ ʌ n t̪
अश्रान्त	ʌ ʃ r ä n t̪
उपनिवेशवाद	u p ʌ n i b e ʃ b ä d̪
सङ्काय	s ʌ ŋ k ä j
ओल्ट	o l ʈ
गथासो	ɡ ʌ t̪ʰ ä s o
कालु	k ä l u
डफ्फा	ɖ ʌ pʰ pʰ ä
पावरनाथ	p ä b ʌ r n ä t̪ʰ
सनसनती	s ʌ n ʌ s ʌ n ʌ t̪ i
उमेर	u m e r
कुचेष्टा	k u t͡ʃ e ʂ ʈ ä
सहसेनानी	s ʌ ɦ ʌ s e n ä n i
जर्फर	d͡ʒ ʌ r pʰ ʌ r
संयम	s ʌ̃ j ʌ m
सुलसुल	s u l ʌ s u l
हृदय	ɦ r i d ʌ j
पूँजीपति	p ũ̯ d͡ʒ i p ʌ t̪ i
गहते	ɡ ʌ ɦ ʌ t̪ e
टाल	ʈ ä l
अपावन	ʌ p ä b ʌ n
चर्चित	t͡ʃ ʌ r t͡ʃ i t̪
खसोखास	kʰ ʌ s o kʰ ä s
कति न कति	k ʌ t̪ i n ʌ k ʌ t̪ i
अभिषेचन	ʌ bʱ i ʃ e t͡ʃ ʌ n
लत्र्याङ्ङ	l ʌ t̪ r j ä ŋ ŋ
दापा	d ä p ä
अनुष्ठान	ʌ n u ʂ ʈʰ ä n
गज्क	ɡ ʌ d͡ʒ k
लाउ	l ä u
प्वाइन्ट	p w ä i n ʈ
गोस्वारी	ɡ o s w ä r i
मुनामदन	m u n ä m ʌ d ʌ n
प्रेसिडेन्ट	p r e s i ɖ e n ʈ
भुटन	bʱ u ʈ ʌ n
ह्वासह्वास	ɦʋaːsɦʋaːs
पुस	pus
रुगरुगी	rugrugɪ
ठूली	ʈʰuːliː
घिनाहा	ɡʱinaːɦaː
वसन्ती	ʋasant̪iː
मुग्लिङ	muglɪŋ
हिक्मत	ɦɪkmat̪
एकौटी	ekaʊʈiː
कीर्तिशाली	kiːrt̪iʃaːliː
खरो	kʰaro
सेन्सर	sensər
चालामाला	t͡ʃaːlaːmaːlaː
एकजाति	ekd͡ʒaːt̪i
सुत्	sut̪
काई	kaːi
कटाहा	kʌʈaːɦaː
परापूर्वकाल	pɾaːpuːɾʋakaːl
उदीयमान	ud̪iːjamaːn
गोत्र	got̪ɾ
राधेश्याम	ɾaːd̪ʱeʃjaːm
उस्ताद	ust̪aːd̪
मानवजाति	maːnʋad͡ʒaːt̪i
जातपतित	d͡ʒaːt̪pat̪ɪt̪
मुसुक्क	musukk
अवास्तविक	ʌʋaːst̪ʋɪk
फाल	phaːl
उल्लसित	ullasɪt̪
कुशासन	kʊʃaːsan
प्रकृतिप्रेम	pɾəkɾɪt̪ipɾem
घुलित	ɡʱulɪt̪
सुनुवाइ	sunuʋaːi
कुँडुली	kʊ̃ɖuliː
पचपच	pat͡ʃpat͡ʃ
कडकड	kʌɖkʌɖ
चुनौती	t͡ʃunaʊt̪iː
ख्याक्क	kʰjaːkk
वहि	ʋəhi
रत्नदास	rat̪nadaːs
भड्खालो	bʱʌɖkʰaːlo
परिच्छेद	pərit͡ʃʰed̪
उत्केन्द्र	ut̪kend̪ɾ
स्तरीयता	st̪əriːjət̪aː
टेनिस	ʈenis
कुचेष्टा	kut͡ʃeʂʈaː
द्वितीया	d̪ʋit̪iːjaː
लोप्रि	loprɪ
सती	sat̪iː
खोल्सी	kʰolsiː
प्यास	pjaːs
छादित	t͡ʃʰɑːd̪it̪
आडिलो	ɑːɖilo
तीर्थयात्रा	t̪iːrt̪ʰjɑːt̪rɑː
आगा	ɑːɡɑː
ताउली	t̪ɑːuliː
अमौलिक	ʌmɔlik
किलोग्राम	kilogrɑːm
कुलवन्त	kulʋʌnt̪
गँगरि	ɡəŋɡri
विद्यार्जन	ʋid̪jɑːrd͡ʒʌn
पितिकपितिक	pit̪ikʌpit̪ik
सुजाक	sud͡ʒɑːk
बलात्कार	bɑːlɑːtkɑːr
ओइरि	oːiri
खोस्	kʰos
डब्बा	ɖʌbbɑː
अन्तर्विकास	ʌnt̪ʌrʋikɑːs
मोल	mol
बान्की	bɑːŋkiː
कखौतो	kʌkʰɔto
खिलाफ	kʰilɑːf
साँढी	sɑːɳɖʱiː
ब्यानर	bjɑːnʌr
झूटो	d͡ʒʱuːt̪o
प्राची	prɑːt͡ʃiː
होड	hoɖ
आखिरी	ɑːkʰiriː
गन्धे	ɡʌnd̪ʱe
म्याउँ	mjɑːũ
एकरुपता	ekʌrupt̪ɑː
घृणास्पद	ɡʱr̩ɳɑːspʌd̪
मेधा	meɖʱɑː
वायरलेस	ʋɑːjʌrles
सप्लाइ	sʌplɑːi
गर्धने	ɡʌrd̪ʱne
सर्जक	sʌrd͡ʒʌk
बाउसे	bɑːuse
गर्भघाती	ɡʌrbʱɡʱɑːt̪iː
बिमाख	bimɑːkʰ
कृयाकलाप	kriːjɑːkʌlɑːp
कुक्रुक्क	kukrukʰ
छोप	t͡ʃʰop
लबेदा	lʌbed̪ɑː
खड्ग	kʰʌɖɡ
रसायन	rʌsɑːjʌn
असन्तुलन	ʌsʌnt̪ulʌn
आत्मपरक	ɑːt̪mʌpʌrʌk
पिरिक्क	pirikk
सिकुटी	sikut̪iː
एनान	enɑːn

    कामोद्दीपक	k ɑː m o d d iː p ʌ k
निजगढ	n i d͡ʒ ɡ ʌ d̪ʱ
भर्सेला	bʱ ʌ r s e l ɑː
घारी	ɡʱ ɑː r iː
लिपु	l i p u
खुसखुसे	kʰ u s ʌ kʰ u s e
लेन	l e n
जम्बु	d͡ʒ ʌ m b u
सुरक्षास्रोत	s u r ʌ kʃ ɑː s r o t
अनरेरी	ʌ n ʌ r e r iː
कलङ्की	k ʌ l ʌ ŋ k iː
संसाधन	s ʌ̃ s ɑː dʱ ʌ n
ढेडु	ɖʱ e d u
अतर्कित	ʌ t ʌ r k i t
औदुम्बर	ɔː d u m b ʌ r
गणतन्त्रीय	ɡ ʌ ɳ ʌ t ʌ n t r iː j
लघुकाव्य	l ʌ ɡʱ u k ɑː v j ʌ
झुर्र	d͡ʒʱ u r r
अज्ञेय	ʌ d͡ʒ ʌ ɲ e j ʌ
बिलौना	b i l ɔː n ɑː
चिल्ल्याउ	t͡ʃ i l l j ɑː u
कामत	k ɑː m ʌ t
अबोधव्यक्ति	ʌ b o dʱ ʌ v j ʌ k t i
जिउनी	d͡ʒ i u n iː
शिलापत्र	ʃ i l ɑː p ʌ t r ʌ
बालाजु	b ɑː l ɑː d͡ʒ u
प्रिन्ट	p r i n t
बरन्डा	b ʌ r ʌ n d ɑː
सोपान	s o p ɑː n
गधा	ɡ ʌ dʱ ɑː
कलजिभ्रे	k ʌ l ʌ d͡ʒ i bʱ r e
अभागी	ʌ bʱ ɑː ɡ iː
जुत्याउ	d͡ʒ u t j ɑː u
बोध	b o dʱ
चुरुक्क	t͡ʃ u r u k k
गणित	ɡ ʌ ɳ i t
आखिरी	ɑː kʰ i r iː
कूटस्थ	k uː t ʌ s tʰ ʌ
एकताली	e k ʌ t ɑː l iː
जुत्त्याउ	d͡ʒ u t t j ɑː u
घुँगुर्कि	ɡʱ ũ ɡ u r k i
अदलबदल	ʌ d ʌ l ʌ b ʌ d ʌ l
कुरूप	k u r uː p
झलझल	d͡ʒʱ ʌ l d͡ʒʱ ʌ l
बीबीसी	b iː b iː s iː
रसिद	r ʌ s i d
बग्रेन	b ʌ ɡ r e n
इस्लामावाद	i s l ɑː m ɑː v ɑː d
टमटम	t ʌ m t ʌ m
झगडा	d͡ʒʱ ʌ ɡ ʌ d̪ʱ ɑː
हैजा	ɦaɪd͡za
जहडी	d͡zʌɦɖi
जङ्गब	d͡zaŋgʌb
केटाकेटी	keʈaketi
पाँद्	pãd
घोचुवा	ɡʱoʧuwa
इन्टेल	inʈel
लाउ	laʊ
लप्रक्क	lʌprʌkʌk
इट	iʈ
झुस्याहा	d͡zʌhusjaɦa
ज्यास्ता	d͡zjaːstaː
पोत्	pot
सुजाक	sud͡zaːk
साहुनी	saːhuni
जा	d͡zaː
लोप्रि	loprɪ
क्रम	kram
सानोठिमी	saːnoʈʰɪmi
पैले	paɪle
बेसारे	beːsaːre
सिलौटो	sɪlaʊʈo
बारा	baːraː
पञ्चायत	paɲʧaːjat
बोध	bodʱ
चाल्ने	ʧaːlne
कान्ड	kaːnɖ
गुहार	guɦaːr
तड्प	tɖp
लागिमेली	laːgɪmeli
दुख्	dukʱ
कलजिभ्रे	kʌlʌd͡zɪbʱre
नैकाप	naɪkaːp
निर्वाध	nɪrvaːdʱ
टेक	ʈek
झन्क	d͡zʌnʌk
अलौटो	ʌlaʊʈo
सन्यास	sʌnjaːs
राजर्षि	raːd͡zʌrʂɪ
दामल१	daːmʌl1
कटहर	kaʈʌɦʌr
तीस	tiːs
ङ्वासङ्वास	ŋwaːsŋwaːs
उल्टोसुल्टो	ʊlʈosʊlʈo
अनिष्ट	ʌnɪʂʈ
राँध्	rãdʱ
गुलाब	gulaːb
कनिके	kʌnɪke
अनेकौं	ʌnekaũ
साँघी	sãɡʱi
मतभेद	mʌt̪bʱeːd̪
र्‌याँर्याँ	rjɑ̃rjɑ̃
असर	ʌsʌr
गुणसागर	ɡʊɳsɑːɡʌr
खतम	kʰʌt̪ʌm
रामनारायण	rɑːmʌnɑːrɑːjʌɳ
दोमट	d̪oːmʌʈ
लडाक	lʌɖɑːk
डिनर	ɖinʌr
पाउलो	pɑːʊloː
दर्शन	d̪ʌrʃʌn
स्वाइँस्वाइँती	sʋɑːĩsʋɑːĩt̪iː
भुटान	bʱʊʈɑːn
पूर्णविराम	pʊːrɳʋirɑːm
तोबा	t̪oːbɑː
बबरमहल	bʌbʌrmʌɦʌl
धर्मशास्त्र	d̪ʱʌrmʃɑːst̪r
देखावटी	d̪eːkʰɑːʋʌʈiː
चेपे	t͡ʃeːpeː
खोप्रो	kʰoːproː
रसि	rʌsi
छयहत्तर	t͡ʃʌjʌɦʌʈʈʌr
गर्	ɡʌr
जैसी	d͡ʒɑːisiː
पोल्टो	poːlʈoː
हतपती	ɦʌt̪ʌpʌt̪iː
खैँच	kʰɑ̃it͡ʃ
अश्वशक्ति	ʌʃʋʌʃʌkt̪i
मैलो	mɑːiloː
फारो	pʰɑːroː
होड	ɦoːɖ
एन	eːn
अनेकौं	ʌneːkɑ̃
जातपक्ष	d͡ʒɑːt̪ʌpʌkʃ
बाँको	bɑ̃koː
छेका	t͡ʃeːkɑː
सुम्लो	sʊmloː
करोड	kʌroːɖ
मारुनी	mɑːruniː
मेरु	meːru
व्यन्जन	ʋjʌnd͡ʒʌn
हस्तक्षेप	ɦʌst̪ʌkʃeːp
पक्राउ	pʌkrɑːʊ
क्यापिटल	kjɑːpiʈʌl
त्यता	t̪jʌt̪ɑː
विपक्षी	ʋipʌkʃiː
भरोसा	bʱʌrosɑː
निर्वाध	nirʋɑːd̪ʱ
लय	lʌj
मोतीकला	moːt̪iːkʌlɑː
छपाइ	ʧʰəpɑi
किट्	kɪʈ
छ्याकटे	ʧʰjɑːkʈe
अनुत्पादित	ənutpɑːdɪt
विमुढ	vɪmuɖʱ
सम्पूर्णता	səmpuːrɳətɑː
अपुष्ट	əpuʂʈ
यगण	jəgəɳ
अमलबाज	əməlbɑːʤ
अध्ययन	ədʱjəjən
तौली	tɔːliː
अश्‌लील	əʃliːl
गद्दारी	gəddɑːriː
त्रियाकलाप	trijɑːkəlɑːp
एकसट्ठी	ekəsʈʰiː
बिघ्नबाधा	bɪɡʱnəbɑːdʱɑː
पूर्ति	puːrti
डवल	ɖəvəl
फैसला	pʰɛːsəlɑː
भूईँचालो	bʱuːiːʧɑːlo
वायरलेस	vɑːjərəlɛs
थुप्रो	tʰupro
गोप्यता	gopjətɑː
अधीन	ədʱiːn
अकथनिय	əkətʰənɪj
नशा	nəʃɑː
टिलटिलती	ʈɪlʈɪlətiː
हिमालचुली	hɪmɑːlʧuliː
तमाखु	təmɑːkʰu
तुलसीपुर	tulsipur
अहह	əhəh
आमसञ्चार	ɑːməsənʧɑːr
पाडी	pɑːɖiː
बत्ताउ	bəttɑːu
खस	kʰəs
शब्दकोष	ʃəbdəkoʃ
नाजी	nɑːʤiː
मेधा	mɛːdʱɑː
बिरौटो	bɪrɔːʈo
उच्छृङ्खल	uʧʧʰrʊŋkʰəl
रूहु	ruːhu
जिनिस	ʤɪnɪs
थाल्नी	tʰɑːlniː
क्याफ्टेरिया	kjɑːftɛriːə
ठेलाइ	ʈʰɛːlɑːi
वेदवाक्य	vɛːdəvɑːkjə
हुर्रि	hurri
भेडा	bʱɛːd̪ɑː
ओझेल	oʤʰɛl
सुबानी	subɑːni
झुत्ती	ʤʱʊt̪ːi
चक्क	t͡ʃʌkː
वहीँ	ʋʌɦĩː
डिबडिब	ɖibɖib
हडबडी	ɦɖʌbɖiː
आदी	ɑːdiː
फ्याल्ल	pʰjɑːlː
रामकृष्ण	rɑːmkrɪʂɳ
टेण्डर	ʈeɳɖər
वाक्यविन्यास	ʋɑːkjʋinjɑːs
आविभूर्त	ɑːʋibʱuːrt
उपनिवेशवाद	ʊpn̪iʋeːʂʋɑːd
पेट्रोलपम्प	peːʈrolpʌmp
कुटुम्ब	kʊʈʊmb
छपन	t͡ʃʰʌpʌn
श्रीमान	ʃriːmɑːn
आती	ɑːtiː
प्रधान	prʌd̪ʱɑːn
बन्दीघर	bʌn̪diːgʱʌr
मैनबत्ती	mɛːnbʌt̪ːiː
युगवाणी	jʊgʋɑːɳiː
भतभती	bʱʌtbʱʌtiː
कोटेश्वर	koʈeːʂʋʌr
लम्मि	lʌmmi
अल्बानीया	ʌlbɑːniːjɑː
झीनू	ʤʱiːnuː
घण्टी	gʱʌɳʈiː
रोध	roːd̪ʱ
जग्गाजमिन	ʤʌgːɑːʤʌmin
वस्तुविनियम	ʋʌst̪ʊʋinijʌm
मेरु	meːru
दावा	d̪ɑːʋɑː
गन्धिलो	gʌnd̪ʱilo
झ्याप्प	ʤʱjɑːpː
अविचलित	ʌʋit͡ʃʌlit
उपविष्ट	ʊpʌʋiʂʈ
यगण	jʌgʌɳ
गन्धर्व	gʌnd̪ʱʌrʋ
पिशाच	piːʃɑːt͡ʃ
इन्कार	in̪kɑːr
आवाज	ɑːʋɑːʤ
अन्य	ʌnj
भियना	bʱijʌn̪ɑː
गुण्डागर्दी	gʊɳɖɑːgʌrd̪iː
सन्चालन	sʌnt͡ʃɑːlʌn
वैधता	ʋɛːd̪ʱʌt̪ɑː
घर्ती	gʱʌrt̪iː
झिँगो	ʤʱĩːgo
कोटेरो	koʈeːro
ढड्याङढुडुङ	ɖʱɖjɑːŋɖʱʊɖʊŋ
चौखुँडे	t͡ʃ aʊ kʰ ʌ̃ ɖ e
आमसञ्चार	ɑː m ʌ s ɲ t͡ʃ ɑː r
अतुल्य	ʌ t̪ u l j ʌ
वायुमण्डल	v ɑː j u m ʌ ɳ ɖ ʌ l
लोक	l oʊ k
इच्छापत्र	i t͡ʃ t͡ʃ ɑː p ʌ t̪ r ʌ
आतङ्कवादी	ɑː t̪ ʌ ŋ k v ɑː d iː
आत्मघाती	ɑː t̪ m ɡʱ ɑː t iː
लुगाफाटा	l u ɡ ɑː f ɑː t̪ ʌ
असहन	ʌ s ʌ h ʌ n
सिलौटो	s i l aʊ t̪ oʊ
आँच	ɑː̃ t͡ʃ
उपनिवेशवाद	u p ʌ n i v eː ʃ v ɑː d
अग्रिम	ʌ ɡ r i m
अस्तबल	ʌ s t̪ ʌ b ʌ l
विषाद	v i ʃ ɑː d
बन्दीघर	b ʌ n d iː ɡʱ ʌ r
साँघी	s ɑː̃ ɡʱ iː
मिर्ग	m i r ɡ
विस्तारी	v i s t̪ ɑː r iː
लुँडे	l ʌ̃ ɳ ɖ e
काहिँला	k ɑː h ĩ l ʌ
तोबा	t̪ oʊ b ʌ
नागरिकता	n ɑː ɡ ʌ r i k ʌ t̪ ʌ
दुरावस्था	d u r ɑː v ʌ s t̪ʰ ʌ
त्रिताल	t̪ r i t̪ ɑː l
पञ्चैती	p ʌ ɲ t͡ʃ aɪ t iː
अङ्कारा	ʌ ŋ k ɑː r ʌ
हरिभक्त	h ʌ r i bʱ ʌ k t̪
अफ्रिका	ʌ f r i k ɑː
घुँक्क	ɡʱ ʌ̃ k k
छयहत्तर	t͡ʃʰ ʌ j ʌ h ʌ t̪ t̪ ʌ r
टुपुटुपु	t̪ u p u t̪ u p u
बर्मा	b ʌ r m ɑː
सम्प्रति	s ʌ m p r ʌ t̪ i
बाध्य	b ɑː dʱ j ʌ
दस्तखत	d ʌ s t̪ ʌ kʰ ʌ t̪
उलामाला	u l ɑː m ɑː l ʌ
वाक्यगठन	v ɑː k j ʌ ɡʱ ʌ t̪ʰ ʌ n
व्रतालु	v r ʌ t̪ ɑː l u
छ्‌वात्लाङ्ङ	t͡ʃʰ w ɑː t̪ l ɑː ŋ ŋ
तत्काल	t̪ ʌ t̪ k ɑː l
हप्कीदप्की	h ʌ p k iː d ʌ p k iː
कछुवा	k ʌ t͡ʃʰ u v ɑː
चमचम	t͡ʃ ʌ m ʌ t͡ʃ ʌ m
भोजपुर	bʱ oʊ d͡ʒ p u r
आसत्ति	ɑː s ʌ t̪ t̪ i
जिबुल्ले	d͡ʒ i b u l l e
स्वाहा	s v ɑː h ɑː
दपेटाइ	d ʌ p eː t̪ ɑː i
समाचारदाता	səmɑːt͡ʃɑːrdɑːtɑː
ठकठकी	ʈʰəkʈʰəkiː
पशुपक्षी	pəʃupəkʂiː
घर्ती	ɡʱərtiː
मनोविज्ञान	mənovid͡ʒɲɑːn
च्यान्टो	t͡ʃjɑːnʈoː
एकत्र	ekətr
रजिस्ट्रार	rəd͡ʒist̪rɑːr
दन्कि	dənki
आशंसित	ɑːʂə̃sit̪
खोस्य्राङखोस्य्राङ	kʰosjrɑːŋkʰosjrɑːŋ
हिक्मत	hikmət̪
वज्राचार्य	vəd͡ʒrɑːt͡ʃɑːrjə
सिल	sil
क्रमाङ्कन	krmɑːŋkən
डगमग	ɖəɡməɡ
पनाति	pənɑːt̪i
तैबिसेक	t̪ɑːibisek
कोक्ल्याँटो	kokljɑ̃ʈoː
खस	kʰəs
नेशनल	neʃənəl
बर्मा	bərmɑː
पिरपिर	pirpir
ढाल्	ɖʱɑːl
निःस्वार्थ	nisvɑːrʈʰ
साङ्ली	sɑːŋliː
अप्रधान	əprədʱɑːn
दधीचि	dədʱit͡ʃi
कागजात	kɑːɡəd͡ʒɑːt̪
प्रतिपद	prət̪ipəd̪
मोफसल	mofəsəl
बौलाउ	bɔːlɑːu
तमोर	t̪əmor
वृद्धि	vr̩d̪d̪ʱi
अनुपकार	ənupəkɑːr
कङ्गाल	kəŋɡɑːl
डिसेम्बर	ɖisembər
अव्यवस्था	əvjəvəsʈʰɑː
पुरस्कार	purəskɑːr
मैलो	mɑːilo
एकतमास	ekət̪mɑːs
अर्च	ərt͡ʃ
अनिष्ट	əniʂʈ
झगड्याहा	d͡ʒʱəɡəd̪jɑːhɑː
उफ्र	ufr
एकजातीय	ekəd͡ʒɑːt̪ijə
बेल्ट	belt̪
छ्‌वात्लाङ्ङ	t͡ʃʰvɑːt̪lɑːŋŋ
शारदा	ʃɑːrdɑː
र्‌याखर्‌याखती	rjɑːkʰərjɑːkʰət̪i
रल्लि	r ʌ l l i
आवाज	ä w ä d͡z
व्यतिरेक	b j ʌ t̪ i r e k
लोकार्पण	l o k ä r p ʌ n
कर्णफूल	k ʌ r ɳ ʌ f u l
हस्तक्षेप	ɦ ʌ s t̪ k ʃ e p
फुकुन्डो	pʰ u k u n ɖ o
ओकल्	o k ʌ l
बरफ	b ʌ r ʌ pʰ
गर्धने	ɡ ʌ r d̪ʱ ʌ n e
देवर्षि	d e b ʌ r ʃ i
जङ्गे	d͡z ʌ ŋ ɡ e
वायुसेना	b ä j u s e n ä
भाद्र	bʱ ä d r
रेलिङ	r e l i ŋ
अथक	ʌ t̪ʰ ʌ k
अभुक्त	ʌ bʱ u k t̪
इकोसिस्टम	i k o s i s t̪ ʌ m
दधीचि	d ʌ dʱ i t͡ʃ i
मालश्री	m ä l ʃ r i
पावर	p ä b ʌ r
मोडेम	m o ɖ e m
छ्याकटे	t͡ʃʰ j ä k ʌ t̪ e
अविचल	ʌ b i t͡ʃ ʌ l
खुल्कि	kʰ u l k i
पुरिया	p u r i j ä
कटुता	k ʌ t̪ u t̪ ä
अव्यवस्था	ʌ b j ʌ b ʌ s t̪ʰ ä
आत्मघाती	ä t̪ m ɡʱ ä t̪ i
दावा	d ä b ä
अश्रान्त	ʌ ʃ r ä n t̪
विधायक	b i dʱ ä j ʌ k
मोसो	m o s o
अनुष्ठित	ʌ n u ʃ t̪ʰ i t̪
अमानुष	ʌ m ä n u ʃ
भुक्लुक्क	bʱ u k l u k k
रत्नदास	r ʌ t̪ n ʌ d ä s
अकर्मण्यता	ʌ k ʌ r m ʌ ɳ j ʌ t̪ ä
कञ्चनजङ्घा	k ʌ n t͡ʃ ʌ n d͡z ʌ ŋ ɡʱ ä
लेस्	l e s
पराल	p ʌ r ä l
प्रोजेक्ट	p r o d͡z e k t̪
दापा	d ä p ä
इट	i ʈ
व्याख्याता	b j ä kʰ j ä t̪ ä
बर्मा	b ʌ r m ä
परमाधिपति	p ʌ r m ä dʱ i p ʌ t̪ i
फेचो	pʰ e t͡ʃ o
आर्जे	ä r d͡z e
द्विज	d b i d͡z

    सुत्	s u t
दनक	d ʌ n ʌ k
कमलनाभ	k ʌ m ʌ l n ʌ bʱ
राडार	r ʌ ɖ ʌ r
राजेश	r ʌ dʒ e ʃ
माझ्	m ʌ dʒ
जनार्दन	dʒ ʌ n ʌ r d ʌ n
एकसट्ठीऔं	e k ʌ s ʌ t̪ʰ i ʌ̃
रेडक्रस	r e ɖ k r ʌ s
उदयोन्मुख	u d ʌ j o n m u kʰ
जिल	dʒ i l
लुटपुट	l u ʈ p u ʈ
अल्बानीया	ʌ l b ʌ n i j ʌ
वक्र	b ʌ k r
फोहरा	pʰ o ɦ ʌ r ʌ
ल्याफल्याफती	l j ʌ pʰ l j ʌ pʰ ʌ t̪ i
चेप्रो	t͡ʃ e p r o
चेपे	t͡ʃ e p e
जनी	dʒ ʌ n i
चण्ड	t͡ʃ ʌ ɳ ɖ
आभासित	ʌ bʱ ʌ s i t̪
आदर्श	ʌ d ʌ r ʃ
उपवक्ता	u p ʌ b ʌ k t̪ ʌ
विस्तार	b i s t̪ ʌ r
रोगब्याधी	r o ɡ ʌ b j ʌ dʱ i
लाद्	l ʌ d
लोचन	l o t͡ʃ ʌ n
अलख	ʌ l ʌ kʰ
एस	e s
कवाज	k ʌ b ʌ dʒ
सुबोल	s u b o l
परमाधिपति	p ʌ r ʌ m ʌ dʱ i p ʌ t̪ i
छ्याकन	t͡ʃʰ j ʌ k ʌ n
संघर्ष	s ʌ ŋ ɦ ʌ r ʃ
सङ्गीन	s ʌ ŋ g i n
हृदय	ɦ ɾ i d ʌ j
हात-हालाहाल	ɦ ʌ t̪ - ɦ ʌ l ʌ ɦ ʌ l
घत्रक्क	ɡʱ ʌ t̪ r ʌ k k
सलिल	s ʌ l i l
सल्याङबल्याङ	s ʌ l j ʌ ŋ b ʌ l j ʌ ŋ
महत्ता	m ʌ ɦ ʌ t̪ t̪ ʌ
जीर्ण	dʒ i r ɳ
रघुवीर	r ʌ ɡʱ u b i r
नोवेल	n o b e l
ससीम	s ʌ s i m
सरौटो	s ʌ r ʌ u̯ t̪ o
कलकलाउँदो	k ʌ l k ʌ l ʌ u̯ n d o
पत्रिका	p ʌ t̪ r i k ʌ
घोप्ट्	ɡʱ o pʰ t̪
पाना	p ʌ n ʌ
चाकडी	t͡ʃ ɑː k ʌ d i
बलाधिकृत	b ʌ l ɑː dʱ i k ɾ i t
पुग्	p ʊ ɡ
घरधुरी	ɡʱ ʌ r ʌ dʱ ʊ r iː
उबार्	ʊ b ɑː r
उल्लसित	ʊ l l ʌ s i t
स्थानीयता	s tʰ ɑː n iː j ʌ t ɑː
सारांश	s ɑː r ɑː ̃ ʃ
अकड	ʌ k ʌ d
ढेडु	ɖʱ eː d ʊ
आन्दोलन	ɑː n d oː l ʌ n
मलहम	m ʌ l ʌ h ʌ m
मङ्गलाचरण	m ʌ ŋ ɡ ʌ l ɑː t͡ʃ ʌ r ʌ n
तुर्लुङ	t ʊ r l ʊ ŋ
पद्यनाटक	p ʌ d j ʌ n ɑː ʈ ʌ k
क्यारेक्टर	k j ɑː r eː k ʈ ʌ r
सावा	s ɑː v ɑː
जा	d͡ʒ ɑː
कट्टु	k ʌ ʈ ʈ ʊ
महिना	m ʌ h iː n ɑː
सोभियत	s oː bʱ iː j ʌ t
गिद्धे	ɡ iː dʱ ʌ eː
उजुर	ʊ d͡ʒ ʊ r
प्रोजेक्ट	p r oː d͡ʒ eː k ʈ
किलोग्राम	k iː l oː ɡ r ɑː m
अविचलित	ʌ v iː t͡ʃ ʌ l iː t
वाच्य	v ɑː t͡ʃ j ʌ
मेडिसिन	m eː d iː s iː n
बिजाइँ	b iː d͡ʒ ɑː iː ̃
उनान्सयौं	ʊ n ɑː n s j ɔː ̃
खोजी	kʰ oː d͡ʒ iː
खौवा	kʰ ɔː v ɑː
जिउ	d͡ʒ iː ʊ
आदि	ɑː d iː
घोप्ट्	ɡʱ oː p ʈ
त्रियाकलाप	t r iː j ɑː k l ɑː p
खबटे	kʰ ʌ b ʌ ʈ eː
चुक्लीखोर	t͡ʃ ʊ k l iː kʰ oː r
वाचस्पति	v ɑː t͡ʃ ʌ s p ʌ t iː
कट्टू	k ʌ ʈ ʈ uː
उनन्‍तीस	ʊ n ʌ n t iː s
उल्टाइ	ʊ l ʈ ɑː iː
वृत्तान्त	v ɾ iː t t ɑː n t
स्वच्छता	s v ʌ t͡ʃʰ t ɑː
ग्याँचे	ɡ j ɑː ̃ t͡ʃ eː
इट	iː ʈ
भविष्यवाणी	bʱ ʌ v iː ʃ j ʌ v ɑː n iː
तन्नेरी	t ʌ n n eː r iː
धुस्नि	dʱ ʊ s n iː
बटुको	b ʌ ʈ ʊ k oː
मैनबत्ती	maɪnbatːi
धरौटी	dʱarɔʈi
ह्वासह्वास	hʋasʰʋas
थ्वाप्प	tʰʋapː
घिनाहा	ɡʱinaɦa
अप्रतिद्वन्द्व	apratidʋandʋ
पाणिनि	paɳini
गोब्र्याउ	gobrjaʊ
लुगाफाटा	lugaɸaʈa
भद्राक्ष	bʱadrakʃ
झीनू	dʒhinu
संपादन	səmpadan
हिमालचुली	himalculi
किम्बु	kimbu
आदिवासी	adivasi
खनाल	kʰanal
दस्तखत	dastakʰat
बग्रेन	bagren
दुर्गादास	durgadas
उगल्चि	ugalci
परमाधिपति	paramadipati
कुँडुलि	kʌ̃duli
आविष्ट	aviʃʈ
अश्रान्त	aʃrant
नक्साल	naksal
कह	kah
कसजू	kasadʒu
बिट	bit
सम	sam
नर्स	nars
लय	lay
रमरमी	ramrami
मतान्तर	matanʈar
थाह	tʰah
खाद्यपदार्थ	kʰadyapadarʈʰ
रातारात	ratarat
फतरि	ɸatari
यथा	yatʰa
अमानव	amanav
र्‌याँर्याँ	rjanrjan
गच्छदार	gacʰadʌr
कसूरदार	kasurdar
जुस	dʒus
वस्तुत:	vastut:
खसोखास	kʰasokʰas
सुनि	suni
टेस्टट्युब	ʈestʈjub
नङ्ङि	naŋgi
एनान	enʌn
बोटे	boʈe

    लुइँलुइँ	l u ĩ l u ĩ
बलाधिकृत	b ʌ l ɑː d̪ʱ i k ɾ i t̪
काव्यचेतना	k ɑː b j ʌ t͡ʃ e t̪ ʌ n ɑː
झुल्के	d͡zʱ u l k e
कोर्याककोर्याक	k o r j ɑː k k o r j ɑː k
उपमान	u p ʌ m ɑː n
क्रीम	k r iː m
पेम्बा	p e m b ɑː
पिरिक्क	p i r i k k
सुकसुक	s u k s u k
ताउली	t ɑː u l iː
खोसेल्टि	kʰ o s e l t̪ i
पुराकथा	p u r ɑː k ʌ t̪ʰ ɑː
जनी	d͡ʒ ʌ n iː
टल्ल	t̪ ʌ l l
सराप्	s ʌ r ɑː p
पलाउ	p ʌ l ɑː u
गृष्म	ɡ ɾ i ʂ m
चुनौती	t͡ʃ u n ɔː t̪ iː
घिरघिर	ɡʱ i r ɡʱ i r
फ्याक्स	pʰ j ɑː k s
शिरीष	ʃ i r iː ʂ
छन्	t͡ʃʰ ʌ n
बबरमहल	b ʌ b ʌ r m ʌ ɦ ʌ l
र्‌याखर्‌याखती	r j ɑː kʰ r j ɑː kʰ t̪ iː
आम्खोरा	ɑː m kʰ o r ɑː
खल्लो	kʰ ʌ l l o
मुस्लिम	m u s l i m
सरौटो	s ʌ r ɔː t̪ o
सत्याग्रह	s ʌ t̪ j ɑː ɡ r ʌ ɦ
डाइथेन	ɖ ɑː i t̪ʰ e n
मध्यस्थता	m ʌ d̪ʱ j ʌ s t̪ʰ ʌ t̪ ɑː
तमाखु	t̪ ʌ m ɑː kʰ u
खोतल्	kʰ o t̪ ʌ l
फागुन	pʰ ɑː ɡ u n
हडबडी	ɦ ʌ ɖ ʌ b ʌ ɖ iː
गम्भीरभावमा	ɡ ʌ m bʱ iː r bʱ ɑː b m ɑː
झकझकाउ	d͡zʱ ʌ k d͡zʱ ʌ k ɑː u
सुपरिवेक्षण	s u p ʌ r i b e k ʂ ʌ n
पुस	p u s
घुइँकि	ɡʱ u ĩ k i
वाक्यविश्लेषण	b ɑː k j ʌ b i ʂ l e ʂ ʌ n
सेक्टर	s e k t̪ ʌ r
तुलसीपुर	t̪ u l ʌ s iː p u r
अर्धचन्द्र	ʌ r d̪ʱ ʌ t͡ʃ ʌ n d̪ r
ओइरि	o i r i
जिनिस	d͡ʒ i n i s
पोर्ट	p o r t̪
कीटाणुनाशक	k iː t̪ ɑː n u n ɑː ʂ ʌ k
हड्डी	ɦ ʌ ɖ ɖ iː
राँध्	ɾä̃d̪ʱ
लँगौटी	lãŋɡɔʈi
बलाधिकृत	bəlɑd̪ʱikɾit
ठनठन	ʈʰənʈʰən
आदर	ɑd̪əɾ
कास्की	kɑskʰi
लोक	lɔk
जा	d͡ʒɑ
ढाड	ɖʱɑɖ
तागत	tɑɡət
कार्बनडाइअक्साइड	kɑɾbənɖɑikʰsɑid
धातु	d̪ʱɑt̪u
साध्या	sɑd̪ʱjɑ
उखाड्	ukʰɑɖ
थुँगा	t̪ʰũɡɑ
धुस्नि	d̪ʱusni
द्रुत	d̪ɾut
सम्भार	səmbʱɑɾ
खपटो	kʰəpʈɔ
सुरेन्द्र	surend̪ɾə
घोप्ट्	ɡʱɔpʈ
गणेशपुर	ɡəneʃpʊɾ
कन्पारो	kənpɑɾɔ
छ्‌वाँके	t͡ʃʰwãke
ताड्	tɑɖ
चिरबिरे	t͡ʃirbire
एकजीउ	ekd͡ʒiu
सेप	seɸ
आदिवासी	ɑd̪iwɑsi
कपी	kəpi
विद्यापीठ	vid̪jɑpiʈʰ
सुनुवाइ	sunuʋɑi
भाद्र	bʱɑd̪ɾə
शब्दकोष	ʃəbd̪koʃ
हिन्दी	ɦindi
भ्रष्टाचार	bʱrəʂʈɑt͡ʃɑɾ
पिरीपिरी	piripiri
धान्	d̪ʱɑn
स्वालस्वाल	sʋɑlsʋɑl
गोठपाला	ɡoʈʰpɑlɑ
अङ्गुलिका	əŋɡulikɑ
झँटाइ	d͡ʒʰãʈɑi
पुतौरो	putɔɾɔ
भरपाई	bʱəɾpɑi
हिक्मत	ɦikmət
लिबलिब	liblib
रिँग्नु	riŋɡnu
अभिषेचन	əbʱiʃet͡ʃən
कुच्चे	kut͡ʃt͡ʃe
मर्का	məɾkɑ
